esp	nah
lugar	-ko
lugar	-lan
sobre	-pan
chico	-tepiton
entre	-titlan
chico	-tontli
-ito	-tsin
pequeño	-tsintli
demaciados	-tsitsin
lugar	-uakan
no	a-
a	a
furioso	aakki
conocedor	aasini
selva	aauatlan
alegre	aauiani
parque	aauilpan
abril	abrili
mármol	achalchiuitl
pepita	acheli
algo	achi
gasolina	achiapopotl
charco	achiauitl
mandón	achichikatlauini
chupadero	achichinki
guardaespaldas	achichintli
estalagmita	achichipiktli
breve	achik
frágil	achikauak
debilitado	achikauali
flojera	achikaualistli
debilidad	achikauayotl
razonable	achikuali
chinampa	achinamilpan
parecido	achineneuki
achiote	achiotl
inflado	achipotsauak
momento	achitonkalistli
átomo	achitotontsin
poquito	achitsin
poco	achitsinko
prohibido	achiualoki
prohibido	achiualoni
molino	achiyamaschiuki
molido	achiyamastik
cerca	achka
pronombre	achkaitl
granero	achkali
capitán	achkautli
bisabuela	achsijtli
grano	achtli
antes	achto
comandantes	achtontekaj
comandancia	achtontekali
comandante	achtontekatl
bisabuelo	achtontli
primero	achtopa
anterior	achtopan
antes	achtotipan
primitivo	achtotlakatl
marea	aejekatl
afganistán	afgania
agosto	agoxto
hidrocálido	aguaskaltekatl
nunca	aik
inmortal	aikmikini
inmortalidad	aikmikistli
padecer	aikni
padecimiento	aiknilistli
acto	ainilistli
ejecutar	aitia
abedul	aititl
patio	aituali
kiosco	aitualkali
portón	aitualoyan
alcance	aiuteittalistli
sirviente	ajachtli
regocijar	ajauia
alguien	ak
alguno	aka
langostino	akachatl
alguien	akaj
grama	akakauastli
marinero	akalachiani
acalán	akalan
grumete	akalanelotl
embarcado	akalasali
sentina	akalayayalistli
barco	akali
embarcadero	akalko
camarote	akalkochiuayan
acanalar	akaloa
pinabete	akalokuauitl
estanque	akalotl
vela	akalpantilistli
avión	akalpatlani
avioneta	akalpatlanitontli
canoa	akalpechtli
buque	akalpoli
pirata	akalteichtekamiktini
puerto	akaltekoyan
lastre	akaltetlalinkatekoni
acanalado	akaltik
navegante	akaltikanemini
navegación	akaltikaneminilistli
grumete	akaltikapanoni
canoa	akaltontli
timonel	akalueltekani
boquilla	akamapichtli
puntero	akamapili
desembocar	akamati
desembocadura	akamatl
acamaya	akamayatl
atrevido	akanixmauki
faltante	akanoyeui
semejante	akantetlaneui
laurel	akapatli
acapulqueño	akapolkatl
exitado	akatkani
cañaveral	akatlan
zampoña	akatlapitsali
pegamento	akatsakuistli
inicialmente	akattopa
gigantón	akauali
baldío	akaualko
maleza	akauatl
alberca	akaxitl
balneario	akaxotlan
pilar	akaxtontli
nadie	akayak
pipa	akayetl
acayucan	akayokan
inocencia	akentenchiuayotl
travesura	akentlattalistli
travieso	akentlattani
necedad	akimamatkayotl
quién	akin
natación	akisalistli
nadador	akisani
velatorio	akochilistli
faltar	akocholoa
mansión	akokali
progresar	akokitsa
progreso	akokitsalistli
alzado	akokitskili
lirio	akokoko
levantar	akokui
antebrazo	akolmaitl
brazo	akolmaitl
alborotar	akomana
alboroto	akomanalistli
alborotador	akomanani
tinaja	akomitl
arriba	akopa
sobre	akopan
mesa	akopechtli
acordeón	akordioni
acocil	akosili
acocil	akosilin
crema	akostik
consolación	akotlasalistli
confortar	akouetsi
confortable	akouetsiki
aliento	akouetsilistli
contemplación	akoueuetilistli
alzar	akoui
despegado	akouili
contemplación	akoyalistli
contemplativo	akoyani
drenaje	akoyoktli
hundimiento	aktitlasatilistli
mal	akuali
maldición	akualitilistli
malicia	akualotl
grosería	akualtlajtoli
elevador	akuanuastli
ruda	akuatsin
ignorante	akuayolo
sanguijuela	akuekueyachin
acantilado	akueskomatl
ola	akueyotl
araucaria	akxoyaokotl
flema	alachin
resbaloso	alaktik
alaska	alaskak
alaskeño	alastekatl
resbalar	alaua
resbaladizo	alauak
junto	alauakatl
liso	alaxtik
albanés	albanekatl
albania	albania
albanés	albaniatl
aleluya	aleluya
argelia	algeria
argelino	algerianekatl
argelino	algeriatl
papagayos	alomej
escroto	aloyotl
villa	altepemaitl
ciudades	altepemej
terreno	altepemili
parcela	altepemilpan
avenida	altepeojtli
procurador	altepepaleuini
alcaldesa	altepesiuatlajtoani
almena	altepetenankoyoktli
ciudad	altepetl
alcalde	altepetlajtoani
municipio	altepetlajtokayotl
paisano	altepetlakak
ciudadano	altepetlakatl
civilización	altepetlakayotl
poblar	altepetlalia
urbanista	altepetlaniani
distrito	altepetlatilantok
distritos	altepetlatilantoke
confederado	altepetlatskoni
rata	altepetusan
urbanidad	altepeyotl
distrito	alteptlatilantok
confederación	alteptlatskostli
bañar	altia
bañado	altik
baño	altikali
baños	altikaltin
boya	amachiotl
estero	amaitl
mora	amakapolin
tildío	amakostitototl
amate	amakuauitl
cartero	amakuiloni
escritor	amamachioni
libreta	amamachiotl
taladro	amamalokotl
papeles	amamej
discurso	amamekatl
distraerse	amana
presa	amanali
papelería	amanamakoyan
charco	amanatli
artesano	amantekatl
tecnología	amantekayotl
artesanal	amantoli
plano	amaometlakuiloli
naipe	amapatoli
ababol	amapotl
ignorante	amatki
analfabetizmo	amatkiyotl
papel	amatl
correo	amatlakuilistli
escribano	amatlakuilo
secretaría	amatlakuilokan
epístola	amatlakuilolanetilistli
carta	amatlakuiloli
remitente	amatlakuilolmachioli
correo	amatlakuiloloyan
graficador	amatlakuilopoalkali
ficha	amatlakuilotontli
cartero	amatlakuilotsakuani
carpeta	amatlatsontli
mapa	amatojtli
billete	amatomin
documento	amatsin
encuadernar	amatsoma
encuadernado	amatsomalili
delta	amaxak
zarzamora	amaxokotl
antifaz	amayakatl
vos	amej-
manguera	amekatl
pozo	ameli
amén	amen
ustedes	ameuan-
ustedes	ameuantin
pesado	ameuatik
usted	ameuatl
fuente	ameyali
cazar	ami
inmoralidad	amikilistli
inmortal	amikini
sed	amikistli
ahogado	amikkatl
laguna	amiktlan
cacería	amilistli
inmortalidad	amilkilisyotl
inmortal	amilkini
tosco	amimatik
dardo	amimitl
cazador	amini
nada	amitla
millonario	amiximatini
desconocido	amixmachtli
ovni	amixmachuastli
confundir	amixmati
confundido	amixmatili
confusión	amixmatilistli
vuestro	amo-
no	amo
irresistible	amoixnauamikilistli
abolir	amoixnauatia
abolición	amoixnauatilistli
abolidor	amoixnauatini
ausente	amoixpani
miope	amoixtlapaltik
impúdico	amoketsak
antiguamente	amokinkantin
desagradecido	amoknelilmatini
necio	amokotontlani
malo	amokuali
feo	amokualnesi
shampoo	amolayotl
jabón	amoli
negación	amolistli
jabonera	amolkaxitl
negar	amomikmana
andariego	amomotlaliani
inquilino	amomotokilismak
diferir	amonamiki
discrepancia	amonamiktli
imprudente	amonauatilmak
odioso	amonauatilmatini
dudosamente	amoneltika
diferencia	amoneneukayotl
diferenciar	amoneneuki
diferente	amoneuki
callar	amonimanauati
inconforme	amoninokaki
tampoco	amono
deprimido	amonotsalani
barato	amopatik
verdugo	amopiluani
sino	amosan
osado	amosaneli
caritativo	amosaneltsoyani
caridad	amosaneltsoyotl
virtuoso	amosankenani
paradigma	amosayotl
ateo	amoteoni
despreciado	amotlaixtilili
bajo	amotlakpak
ostinado	amotlakuauak
infinito	amotlamini
cobarde	amotlapaltik
incoloro	amotlapaltik
gratis	amotlasotli
desatento	amotlatini
desatención	amotlattilistli
manso	amotlaueli
nada	amotlein
vuestro	amouan
imposible	amoueli
librería	amoxatli
capítulo	amoxexelistli
literato	amoxikuilo
bibliotecario	amoxiutlatiani
librero	amoxkali
alfabeta	amoxmatki
lector	amoxpouani
margen	amoxtentli
libros	amoxtin
prólogo	amoxtlajtoalpeualistli
glosario	amoxtlajtoli
índice	amoxtlajtoltsintli
literatura	amoxtlajtoyotl
biblioteca	amoxtlatiloyan
libro	amoxtli
librería	amoxtlikoyan
tomar	ana
marginado	anak
aislado	anakmosatlani
allende	anali
allende	analko
gitano	andaloxtekatl
adios	anej
superfluo	anekilistli
vanidad	anekiloyotl
escasear	anekotona
escasez	anekotonalistli
necesidad	anematilistli
disimulado	anemokaknekili
disimular	anemokkakneki
disimulo	anemokkanekilistli
disimulador	anemokkanekini
bahía	anepalko
depravado	anetlakualtilili
depravación	anetlakualtilistli
ellos	aneuan-
ellos	aneuantin
útil	aneuatsi
inglés	anglitekatl
inglés	anglitl
inglaterra	anglitlalpan
anglicano	anglitlaltekatl
traer	anilitia
tacaño	aninokotontlani
descarar	aninomamati
descarado	aninomamatini
transportar	aniuaya
diariamente	ankimo
ámsterdam	ansterdania
ángel	anxeli
ángel	anxelin
apenas	aokaya
miedoso	aokichyolo
miedoso	aokkichyolo
pulque	aoktli
insoportable	aokueli
pendejo	aompaneuak
pendejada	aompaneualistli
desgraciado	aompaneui
desgracia	aompayotl
inconveniente	aontenekini
ociosidad	aotlakanamiyotl
seguro	aoui
arroyo	apachakatl
diluvio	apachioualistli
apache	apachtli
saltar	apancholoa
saltador	apancholoani
salto	apancholoanilistli
marino	apankayotl
dique	apantlakuiuayan
acequia	apantli
apapachar	apapachoa
cazuela	apastetl
tina	apastlapaloni
coladera	apastli
barato	apatiuki
entelerido	apichauki
desvergonzar	apinaua
desvergonzado	apinauali
vergüenza	apinaualistli
mosquete	apipiloluastli
libélula	apipiyalotl
inanición	apismiki
cámara	apitsali
diarrea	apitsatli
hambriento	apitsmikini
hambruna	apitsmikistli
gula	apitsolistli
vapor	apojtli
wc	apolanko
wc	apolankoyan
geiser	apopokatl
ámbar	aposonali
espuma	apotsonakilotl
nata	apotsonali
espuma	apotsontli
enlamar	apoxkauki
apóstol	apoxtoli
aragonés	aragonekatl
aragonés	aragoni
aragón	aragonia
aruba	aroba
tlaquixtilli	arrankado
asenso	asauyatl
quizá	asej
espulgar	aselana
liendre	aseli
liendre	aselin
liendroso	aseloni
desagradable	asemeli
azerbaiyano	aserbaiyanekatl
azerbaijano	aserbaiyatl
azerbaiyán	aserbayania
iceberg	asesekpan
frutilla	asesexokotl
aguanieve	asetl
comprender	asikamati
comprendido	asikamatili
localizado	asiki
localizar	asiki
arrebatar	asitiuetsi
alcance	asitl
aljófar	asitlali
aljófar	asitlalin
sirena	asiuamichtli
escamoles	askamoli
hormiguero	askapotsali
hormiguero	askaxali
casi	aski
alas	asmej
probablemente	aso
calma	asomali
experiencia	asomaluauetl
blancura	astapiltik
aspa	astektli
alado	astitok
ala	astli
ausente	atak
atreverse	ateixkoa
atrevimiento	ateixkotlachialistli
atrevido	ateixkotlachiani
desobediente	atekakini
molesto	atekauki
alberca	atekaxmatemaloyan
aljibe	atekochtlali
aljibes	atekochtlaltin
jaguëy	atekochtli
presa	atekochtsakuali
hidropesía	atemalistli
empiojar	atemi
cascada	atemoktli
cascada	atemostli
enfrentar	atemouia
piojoso	atempachtli
súbitamente	atenamachpan
tejado	atenamitl
atenas	atenia
lago	ateskatl
bravo	atetechasini
desobediencia	atetlakamatilistli
desobediente	atetlakamatini
almeja	atexakatl
derretirse	atia
esfumado	atik
derretir	atilia
rellenar	atipochoa
metáfora	atiuatsolistli
encomendar	atiuitsoa
encomienda	atiuitsouilistli
mollera	atla
marisco	atlachaneki
parlanchín	atlajtoalamini
incorregible	atlakaki
bruto	atlakamachtili
travesura	atlakanemilistli
travieso	atlakanemini
disolución	atlakaneminilistli
cruel	atlakanesi
revoltoso	atlakasemeli
gratis	atlakasoyotl
descortés	atlakatlajtoak
descortesía	atlakatlajtolistli
inhumanamente	atlakayotika
crueldad	atlakayotl
barranca	atlakomoli
ninfa	atlakuisiuatl
aljibe	atlalili
hidrosfera	atlalistli
presunto	atlamati
presunción	atlamatilistli
ahogar	atlamiki
ahogado	atlamikini
canotaje	atlanetlaminalistli
puro	atlaneyolo
gotero	atlanteittani
atlante	atlantekatl
atlantida	atlantiko
ala	atlapali
agonizar	atlasa
vil	atlasotli
lanzadardos	atlatl
perseguido	atlatlamachtili
ahogarse	atlaua
aburrido	atlauinani
cañón	atlautli
quebrada	atlauxomoli
nada	atle
inservible	atleinakkak
solitario	atleinemik
avaricia	atlekikaualistli
codicioso	atlekixkauak
rebajar	atlelitia
rebaja	atlelitilistli
suicidio	atletilistli
aguardiente	atletl
desdichado	atleueli
indiscreto	atleuelitik
haragán	atleyeni
bebedor	atlini
vaso	atliuani
atolero	atolchiuki
atole	atoli
pelón	atomiyo
fiebre	atonauilistli
asoleado	atonauki
gaviota	atototl
trucha	atoyamichin
rivera	atoyatentli
río	atoyatl
riachuelo	atoyatontli
compuerta	atsakuali
presa	atsakuali
pera	atsapotl
estanque	atskaualo
pilote	atsontsontli
y	au
reñir	aua
rociar	auachia
rocío	auachtli
guacamole	auakamoli
aguacates	auakatin
aguacate	auakatli
acuario	auakoyan
perfume	aualistli
bellota	auatomatl
agotamiento	auatsalistli
agotar	auatsi
carrasco	auauatl
aguautle	auautli
drupa	auaxokotl
amordazado	auelatoani
refinería	auelnemilistli
ahuehuete	aueuetl
nivel	aueyak
fragante	auiak
desodorante	auiakatl
canela	auiakpopotli
perfumar	auialia
burdel	auiankali
turista	auikyani
turismo	auikyanilistli
vagabundo	auikyauki
turistear	auikyayoa
turista	auikyayoani
turismo	auikyayotl
presumido	auilatoani
alegría	auilistli
prodigo	auilkixtiani
sexo	auilnelistli
fornicar	auilnemi
lujurioso	auilnemiki
vicioso	auilnemini
vicio	auilneminilistli
sexual	auilneyo
sexualidad	auilneyotl
masturbar	auiltepolia
masturbación	auiltepolistli
deportivo	auiltikayok
deporte	auiltikayotl
juguetones	auiltsonkuitlamej
juguetón	auiltsonkuitlatl
lujuria	auineminilistli
desodorante	auitili
juguete	auitsonxoloni
aromatico	auiyak
aromático	auiyo
teibolera	auyani
burdel	auyankali
aluvión	axachtli
ahora	axan
delta	axeloli
asia	axia
asiático	axiatekatl
asiático	axiatl
apuntado	axiltili
maquillaje	axin
acercar	axitia
acercamiento	axitialistli
hotel	axiuayan
hotelero	axiuayani
sanitario	axixkali
muladar	axixpan
orina	axixtli
posesión	axkaitl
luego	axkampa
hoy	axkan
presente	axkanilistli
actualmente	axkanistika
actualmente	axkantika
adueñar	axkatia
dueño	axkatiani
dueños	axkatianimej
hacienda	axkatl
abundar	axkauia
abundancia	axkauilistli
dominio	axkayotl
burra	axnosiuatl
burro	axnotl
rebuznar	axnotsatsi
rebuznido	axnotsatsilistli
salamandra	axolokuetspalin
bagre	axolomichin
ajolote	axolotl
estuario	axomoli
asturias	axturia
asturiano	axturiatekatl
asturiano	axturiatl
nadie	ayak
sonaja	ayakachtli
temprano	ayakuael
norte	ayamiktlan
norteño	ayamiktlani
crudo	ayamotlakxotili
ayuno	ayatlekikuak
lentamente	ayaxkanyotika
desquebrajar	ayayanoa
pensar	ayekilua
pensamiento	ayekimatilistli
pensador	ayekimatini
todavía	ayemo
agachar	ayeutiuetsi
hacer	ayi
cambiado	ayok
desaparición	ayokakatsintli
caparazón	ayokalotl
imprudente	ayolomatki
pozo	ayoluastli
aguamiel	ayonekutli
calabaza	ayotli
armadillos	ayotochtin
armadillo	ayotochtli
archipiélago	ayoualtlaltin
fácil	ayoui
facilitar	ayouika
fácilmente	ayouika
facilidad	ayouilistli
fácilmente	ayouitika
jugoso	ayoyo
desacierto	ayukayotl
bi	b
bahamas	bajamaj
barbados	barbadiaj
barcelona	barselona
belarus	belarruxia
belgica	belxika
belga	belxikatl
belga	belxitekatl
bermudas	bermudiaj
botswano	botsuantekatl
brasil	brasilia
brasileño	brasiliatl
brasileño	brasiltekatl
bruselas	bruxelia
buda	budateotl
birmania	burmia
birmano	burmianekatl
birmano	burmiatl
burundi	burundia
butanés	butanekatl
bután	butania
butanés	butaniatl
chi	ch
vocerío	chachaiakistli
chachalaca	chachajalakatototl
áspero	chachakuak
hablador	chachalakani
chachalaca	chachalakatl
chachalaca	chachalakatototl
destartalar	chachalaktia
destartalado	chachalaktik
destartalador	chachalaktli
murmurador	chachalani
jactarse	chachamaua
jactado	chachamautli
chad	chadia
camarón	chakali
agusanarse	chakaliui
calloso	chakayoli
gladiatorio	chakmoli
destemplado	chalani
esmeralda	chalchiuitl
joyería	chalchiukali
chalchicomula	chalchiukomolan
joyero	chalchiuximatki
ciénaga	chalkani
chalca	chalkatl
xalco	chalko
chamaco	chamako
chamagoso	chamaokosok
engordar	chamaua
crecido	chamauak
desaliñado	chancho
casero	chanej
salvaje	chanek
cheneque	chaneki
departamento	chankali
vivir	chanti
vivir	chantia
casas	chantin
familia	chantlakauan
granja	chantlalkali
condominio	chantlayokan
casa	chantli
desprender	chapani
empapado	chapankini
saltamontes	chapoli
chapulín	chapolin
chabacano	chauakatl
albaricoque	chauakuauitl
celos	chauastin
celar	chauatilia
celoso	chauatl
chihuahuense	chauauani
plaga	chauitstli
chayote	chayotli
ingeniar	chialia
azucarar	chiankaka
mazapán	chiankakatetl
azúcar	chiankakatl
azucarado	chiankakayo
diesel	chiantletl
chiapaneco	chiapanekatl
chiapaneco	chiapatl
carretera	chiapopojtli
chapopote	chiapopotl
petrolero	chiapopotlani
chía	chiatl
grasoso	chiauik
aceite	chiauikayotl
grasa	chiauisotl
oruga	chiauitl
aceite	chiauitli
escupidor	chichani
alhaja	chichetl
perro	chichi
amargo	chichik
hiel	chichikatl
mancha	chichikaui
descarado	chichiki
grito	chichikitsatsilistli
disparejo	chichikok
bisabuelo	chichikoli
amargoso	chichiktik
chichicuilote	chichikuilotl
bisabuela	chichilamatl
enrojecido	chichiliuili
rojo	chichiltik
petirrojo	chichiltototl
perros	chichimej
chichimecas	chichimekaj
chichimeca	chichimekatl
dolor	chichinakatl
doloroso	chichinaktik
afligido	chichinatsali
mamador	chichini
mamado	chichinik
mamón	chichininpoli
chupador	chichinki
quemar	chichinoa
quemado	chichinoli
incendio	chichinolistli
bello	chichipaltik
destilar	chichipina
destilado	chichipinili
destilación	chichipinilistli
amamantar	chichiti
amamantado	chichitili
rabioso	chichitlauelilo
rabia	chichitlauelilokayotl
mancha	chichitli
seno	chichiuali
ladrerío	chichiuauake
mamila	chichiuayoli
arremedar	chichiuia
arremedado	chichiuili
arremedo	chichiuilistli
perruno	chichiyotl
abrojo	chikalotl
duro	chikauak
fortaleza	chikaualistli
dureza	chikaukayotl
fuerza	chikautilistli
fuerte	chikautok
ruiseñor	chikimolin
chico	chikitl
chiquito	chikiton
chiquitín	chikitsin
canasta	chikiuitl
básquetbol	chikiutapayolistli
inframundo	chiknaumiktlan
cielo	chiknautopan
junto	chiko
siete	chikome
domingo	chikomeiluitl
sospecha	chikotlamanilistli
celoso	chikotlamatini
sospechar	chikoyoloa
sospechoso	chikoyoloani
sospecha	chikoyotl
chicle	chiktli
callado	chikuakoli
seis	chikuase
sábado	chikuaseiluitl
chilaca	chilakatl
chilaquil	chilakili
chilaquil	chilakilitl
chileno	chilantekatl
chilate	chilatl
chile-atole	chilatoli
chile	chili
rábano	chilkamojtli
salsera	chilkaxitl
salsa	chilmamoli
chilmole	chilmoli
rojo	chiltik
calandria	chiltototl
especia	chilxiuitl
escudo	chimali
escudarse	chimalkaltia
escudero	chimalki
chisme	chimiskoli
chismorrear	chimiskouia
chismoso	chimiskouik
chinampa	chinamilpan
cerco	chinamitl
deshorden	chinkatl
chingar	chinkua
chingadera	chinkualaktli
jodido	chinkuali
alergico	chinkualnematini
urticaria	chinkualsauatl
reluciente	chipakkaltik
castidad	chipauakanelistli
pureza	chipauayotl
herir	chipeliueskixtia
herida	chipeliui
chipriota	chiprianekatl
chipriota	chipriatl
dolor	chisiuinakilistli
chicloso	chitik
forma	chiualistli
culto	chiualtlakatl
cultura	chiualtlakayotl
verbo	chiuatlajtoli
ladrido	chiuaualistli
chihuahuense	chiuauani
chihuahuense	chiuauatekatl
chihuahuense	chiuauatl
llanto	chokakilistli
llanto	chokalistli
bramido	chokiktli
llanto	chokilistli
chillido	chokistli
huir	choloa
corrido	chololi
despeñado	cholololi
cholulteca	chololtekatl
extranjero	chontali
xenofobia	chontalmamatilistli
xenofóbico	chontalmamatli
teatro	chukan
di	d
dinamarca	dania
danés	daniatekatl
danés	daniatl
dedal	dekaxitl
diciembre	disiembri
diskette	dixketl
domingo	domingo
dominca	dominika
dominicano	dominikatl
dominicano	dominitekatl
e	e
contraviento	ejekaixnamikilistli
tempestad	ejekakiauitl
tromba	ejekakoamixtli
atmósfera	ejekalistli
aeropuerto	ejekalkixoayan
remolino	ejekamalakatl
aires	ejekamej
huracán	ejekanamiktilistli
paracaidista	ejekatemoani
viento	ejekatl
aérodeslizador	ejekatlapalki
aventador	ejekatsakauiloni
rompeviento	ejekatsakuili
apolillarse	ejemi
gárgola	ekakoyoktli
soya	ekatl
anorak	ekatsakuili
escala	ekauastik
proporción	ekauastilistli
protector	ekauyo
concha	ektli
nácar	ekyolotli
agruras	elchichinatl
convencer	eleki
convencerse	elekia
convencido	elekili
convencidos	elekiltin
convencimiento	elekitl
pena	eleli
marfil	elepanomitl
desear	eleuia
hígado	eli
deseoso	eliutili
deseo	eliutilistli
deseoso	eliutistik
hepatitis	elkokolistli
espalda	elkomali
elote	elotl
magnolia	eloxochitl
calvario	elpanchichiko
pecho	elpantli
suspirar	elsisiui
suspiro	elsisiuilistli
hígado	eltapachtli
tartamudo	eltsatsaki
tartamudo	eltsatsakini
tartamudear	eltsatsakui
papada	eltsotsoli
alma	eluayotl
frijoles	emej
enero	enero
aljófar	epyolopisili
carnal	esisiutli
vena	eskoktli
eslovaquia	eslovakia
esloveno	eslovenekatl
eslovenia	eslovenia
esloveno	esloveniatl
morcilla	esnakakuitlaxkotli
sangrar	eso
sangrado	esoli
sangría	esolistli
sangradera	esoloni
sangrador	esoltesoni
sangriento	esoni
ágata	estekpatl
tuberculoso	estlatlaxtini
sangre	estli
estocolmo	estokolmo
estonio	estonekatl
estonia	estonia
estonio	estoniatl
granado	esxokokuauitl
granada	esxokotl
pesado	etik
fríjol	etl
frijolar	etlan
habichuela	etontli
agitar	etsona
agitador	etsonki
agitación	etsontilistli
agitado	etsontli
partir	eua
pergamino	euamatl
correa	euamekatl
cinturón	euanelpiloli
maleta	euapetlakali
talabartería	euapitskali
cuero	euatl
cazadora	euatlamamali
gaitero	euatlapitsalnemini
pandero	euaueuetl
alforja	euaxikipili
escamado	euayotlastli
euro	euro
chícharo	exotl
habichuela	exotontli
anteantier	eyopan
fi	f
febrero	febrero
finlandia	filandia
finlandés	filantekatl
finlandés	filatl
gi	g
gabonés	gabonekatl
gabonés	gaboniatl
francés	galitekatl
francés	galitl
gallego	galixiatl
gallego	galixitekatl
ghana	gania
guelaquetza	gelagetsa
gelatina	gelatinatl
granadino	granadatl
granada	granadia
granadino	granatekatl
infierno	ichantletl
mameluco	ichkakonetilmali
cordero	ichkakonetl
ovejas	ichkamej
playera	ichkanemastli
pastorear	ichkapia
pastoril	ichkapixkayotl
pastor	ichkapixki
estopa	ichkasoli
chamarra	ichkatlamamali
borra	ichkatlapopoloak
lana	ichkatsomitl
dama	ichpochsiuatl
doncellas	ichpochtin
donsella	ichpochtli
virginidad	ichpochyotl
damita	ichpokakonetl
vaporoso	ichpotikayotl
confidencial	ichtakayo
secreto	ichtakayotl
robar	ichteki
ladrones	ichtekke
ladrón	ichtekki
secretario	ichtlakatlajtopiani
análisis	ijitlakolistli
respirar	ijiyotia
soportar	ijiyouia
soportado	ijiyouili
soporte	ijiyouilistli
así	ijkin
así	ijkon
aportado	ijkuaili
aportar	ijkuailia
cuando	ijkuak
escribir	ijkuiloa
escrito	ijkuilotik
descompuesto	ijtlako
descomponer	ijtlakoa
decir	ijtoa
aliento	ijyotl
por	ik
con	ika
consonante	ikakakistli
occidente	ikalakian
occidental	ikalakiani
occidental	ikalakini
pelear	ikalia
atrás	ikampa
como	ikan
erecto	ikatok
bastantes	ikimej
oriente	ikisayan
oriental	ikisayo
tejido	ikitilistli
telar	ikitiualoyan
tela	ikitiuatli
ayudar	iknelia
atuda	iknelilistli
caridad	ikneliyotl
hermano	iknitl
amiguito	ikniupili
amiguitos	ikniupipil
amigable	ikniutiloni
amigo	ikniutli
revolución	ikniuyaoyotl
amistoso	ikniuyo
piedad	iknoakayotl
miserable	iknoli
comprender	iknomati
comprensión	iknomatilistli
comprensivo	iknomatki
mendigar	iknopiluia
pobre	iknotl
pobres	iknotlakamej
mendigo	iknotlakatl
indigencia	iknotlakayotl
desamparado	iknouak
desamparo	iknouatl
miseria	iknoyotl
roncar	ikotoka
ronquido	ikotokilistli
silla	ikpali
contener	ikpia
índice	ikpialitoamoxtli
contenido	ikpialitok
lámpara	ikpikaxitl
foco	ikpiloli
semáforo	ikpimachiotl
eléctricidad	ikpitikayotl
eléctricista	ikpiuki
izote	iksotl
eclipse	ikualotl
talón	ikxitl
devanar	ilakatsoa
devanado	ilakatstik
solitaria	ilamaokuili
solitaria	ilamaokuilin
viejota	ilamapoli
vieja	ilamatl
viejilla	ilamatontli
viejita	ilamatsin
viejecita	ilamatsintli
aguardiente	ilistli
abedul	ilitl
olvidar	ilkaua
extrañado	ilnamikili
abreviar	ilochtia
amarrar	ilpia
amarrado	ilpitok
ovni	iluikalpatlani
telescopio	iluikamachioli
astronauta	iluikanemini
astrología	iluikatlamatilistli
astrólogo	iluikatlamatini
astro	iluikatlamatli
astronomía	iluikatlatilistli
planetario	iluikatlayokan
cosmíco	iluikayotl
día	iluitl
fiesta	iluitsintli
festividad	iluiyotl
tener	imakasi
época	imaniatl
pendejos	imaxtli
pierna	imetstli
martir	imikistlaneltiliani
luego	immanon
oportunidad	immanyotl
sobrar	imokaua
el	in
atender	ina
atendido	inali
apropiado	inamik
atento	inani
cercano	inauak
india	india
indio	indiatl
indonesia	indonesia
indonersio	indonesiatl
indio	indotl
indio	indotlakatl
hinduismo	indoyotl
aroma	inekistli
artículo	inik
estos	inimeke
esta	inin
esa	inon
por	ipampa
en	ipan
general	ipanokayotl
costar	ipati
hipopótamo	ipopotamotl
irak	irakia
iraquí	irakiatl
iraquí	irakitekatl
irán	irania
iraní	iraniatl
iraní	iranitekatl
irlandés	irlandatl
irlanda	irlandia
irlandés	irlantekatl
despertar	isa
solo	isel
solitario	isetlakatl
temprano	isik
despertar	isitia
derpertar	isitistli
rápido	isiukak
veloz	isiukak
ligero	isiukayo
diligencia	isiukayotl
surgimiento	iskali
islandés	islandatl
islandia	islandia
islandés	islantekatl
blanco	istak
salero	istakaxitl
blancura	istakayotl
baba	istaktli
descolorido	istaleuak
losa	istapali
ixtapa	istapan
cocaína	istapisiuxitl
blanco	istatik
salmuera	istayotl
decolorar	isteleua
decolorado	isteleuatik
frío	istik
mentira	istlakatilistli
falsedad	istlakayotl
obsidiana	istli
despierto	istok
cuaderno	isuamoxtli
hoja	isuatl
itacate	itakatl
lonchera	itakaxitl
honor	itaukayotl
dentro	itech
jurar	itechtlajtoa
acreedor	itechtlaktok
joroba	itepotsotilistli
síndrome	itestlajtlakoli
barriga	itetl
interior	itik
señalar	ititi
panza	ititl
cuándo	itkin
algo	itla
masacre	itlakamiktilistli
generosidad	itlakayotl
dañado	itlakoli
daño	itlakoltilistli
italia	itlalia
italiano	itlaliatekatl
italiano	itlaliatl
conceder	itlani
ceder	itlania
concedido	itlanili
sudadera	itokalnetsuilistli
short	itokaltsatontli
costumbre	itoktli
asfixia	itomikistli
danzar	itotia
danza	itotilistli
hielo	itskatki
congelador	itskaxitl
esquite	itskitl
perro	itskuintli
perruno	itskuinyotl
ceja	itsonkuatoli
helado	itstik
obsidiana	itstli
bisturí	itsualistli
visible	ittoni
y	iuan
interesante	iuani
conjunción	iuanistli
desguanzado	iuatik
desguance	iuatilistli
de	iuik
de	iuikpa
natural	iukayo
naturaleza	iukayotl
bastante	ixachi
americanos	ixachitlakaj
sonrrojado	ixchichiliui
sonrojar	ixchichilka
actuar	ixeuayilia
actuación	ixeuayilistli
dramático	ixeuayo
teatro	ixeuayotl
atrever	ixeui
sustituir	ixiptlati
cinematografía	ixiptlayolistli
cinematografo	ixiptlayotiani
imaginación	ixiptlayotl
imagen	ixiptli
cocido	ixkali
dorar	ixkati
verbo	ixkauili
tamaño	ixkichi
tanta	ixkichi
esquí	ixkilistli
disputado	ixkomakali
concurso	ixkomakalistli
competitividad	ixkomakayotl
competencia	ixkomalistli
semblante	ixkonexilistli
particula	ixkoyan
criterio	ixkoyotl
ceja	ixkuamoli
despistado	ixkuapak
despistado	ixkuapali
embaucar	ixkuepa
engañar	ixkuepa
lagañoso	ixkuikuitlak
conocido	ixmachtli
conocer	ixmati
conocido	ixmatili
tímido	ixmauki
lidiar	ixnamiki
despedir	ixnaua
periculosis	ixokuaitl
ante	ixpan
tuerto	ixpatsak
ahuyentar	ixpeui
ciego	ixpopoyok
cegado	ixpopoyoli
cegar	ixpopoyoti
ceguera	ixpopoyotl
encandilar	ixpoyaua
israel	ixrralia
israelí	ixrralnekatl
mangle	ixtaktsin
empolvado	ixtaliuik
ojo	ixtelotli
tez	ixtetsauakak
lentes	ixteuilotl
pupila	ixteutli
caras	ixtin
descolorido	ixtisektik
efélides	ixtiseuatl
demostrar	ixtlalia
cegera	ixtlaltemilistli
razón	ixtlamachilistli
razonamiento	ixtlamakilistli
experimentar	ixtlamani
experimentar	ixtlamatia
experiencia	ixtlamatilistli
experimentado	ixtlamatini
delante	ixtlan
osado	ixtlapaltik
entorpecido	ixtlapaltilili
entorpecimiento	ixtlapaltilistli
demostración	ixtlatilistli
valle	ixtlauak
campo	ixtlauatl
campero	ixtlauatlakatl
desvelar	ixtlaui
desvelado	ixtlauik
vigilancia	ixtosolixtli
pestaña	ixtsontli
pedo	iyeli
pedorrear	iyelia
pedorro	iyelmiexini
pedorro	iyemiexini
asfixiarse	iyomiki
asfixiado	iyomikki
lucido	iyotili
castigo	iyouili
hi	j
griego	jelenatl
griego	jelenotekatl
grecia	jelenoyan
suizo	jelvetekatl
suiza	jelvetia
suizo	jelvetiatl
hidalguense	jidalgatl
hidalgo	jidalgo
hidalguense	jidaltekatl
jerusalén	jierosalima
españolismo	jispanilistli
español	jispantekatl
español	jispantlakatl
hediondo	jiyak
holandés	joladatl
holanda	jolandia
holandés	jolantekatl
ci	k
estar	ka
cacique	kachikatl
suela	kachuapali
cafetera	kafekaxitl
café	kafetsin
pues	kaj
sonido	kakalakastli
enclavarse	kakalaua
cáscara	kakalotl
bocas	kakama
carrilludo	kakamak
roncha	kakamoliuilistli
caspa	kakapaxtli
saturar	kakatsa
castaña	kakauakomitl
fama	kakauanilistli
hueco	kakauatik
cacao	kakauatl
madero	kakaxtli
desmoronar	kakayaka
desmoronado	kakayakak
burlar	kakayaua
burlado	kakayauak
burla	kakayauatl
consejo	kakilistli
disco	kakiskopinaloni
declarado	kakistili
declarar	kakistilia
resonante	kakistini
efectivamente	kakseseyane
calzar	kaktia
soledad	kaktimanilistli
zapatos	kaktin
calmado	kaktiuetsik
zapato	kaktli
callado	kaktok
descalzo	kaktonki
suela	kakxopetlatl
entrada	kalakian
egresado	kalakini
puerta	kalakoayan
puerta	kalakouayan
solar	kalali
caserío	kalan
cucaracha	kalayotl
sometido	kalchaki
constructor	kalchiuani
masonería	kalchiukamatilistli
albañil	kalchiuki
construido	kalchiutli
casero	kalej
caseros	kalejke
casa	kali
estancia	kalitik
devenir	kaliui
portal	kalixatl
portal	kalixekatl
frontera	kalixkuatl
rancho	kalixtlauatl
distancia	kalkayotl
albañil	kalketsani
alarife	kalketski
musaraña	kalkimichin
techar	kalkua
techado	kalkuatli
calcuta	kalkutan
colegio	kalmachtiloyan
construcción	kalmanalistli
arquitecto	kalmanani
arquitectónico	kalmanayo
arquitectura	kalmanayotl
salón	kalmelaktli
chofer	kalmimiloani
remolque	kalmimilolchan
autobús	kalmimiloli
esquina	kalnakastli
acceso	kalokoayan
caparazón	kalotl
hidalgo	kalpanpili
mayordomo	kalpixki
barrio	kalpoli
dialecto	kalpoltlajtoli
casucha	kalsoli
rincón	kaltechtli
zaguán	kaltemitl
puerta	kaltentli
caseta	kaltepiton
cochera	kalteposkalnejnenki
casas	kaltin
alhaja	kaltlatlakitl
prisión	kaltsakualko
callejón	kaltsalantli
bermuda	kaltsamaxtli
pantalón	kaltsatl
pantaloncillo	kaltsatontli
quijada	kamachali
mandíbula	kamachalkuauyotl
bocas	kamaktin
boca	kamaktli
trabalenguas	kamanalatoli
broma	kamanali
mitología	kamanalyotl
bromear	kamanatlajtoa
mejilla	kamapantli
bigote	kamasontli
cachete	kamatetl
boca	kamatl
bigote	kamatsontli
bogotón	kamatsonyo
maduro	kamauak
hocicón	kamaxipoli
camboya	kambodia
camboyano	kambodiatl
camerunés	kamerunekatl
camerunés	kameruniatl
camello	kameyotl
moreno	kamilektik
café	kamiltik
camioneta	kamioni
tunica	kamitl
morado	kamojpaltik
tierno	kamojtik
papa	kamojtli
berenjena	kamojtomatl
morder	kampaxoa
adonde	kan
a	kana
a	kanapa
canario	kanariotl
delgado	kanauak
sien	kanauakantli
delicadeza	kanauakayotl
espinacas	kanaukilitl
canadiense	kanautekatl
canadá	kanautlan
pato	kanautli
donde	kanik
dónde	kanin
sano	kankenami
crujido	kapani
unido	kapanki
capulín	kapolkuauitl
grosella	kapolxokotl
caracas	karakaj
ciertamente	kasaneli
efectivo	kasaneli
efectividad	kasanelistli
kazajstán	kasaxtania
kazajo	kasaxtaniatl
kazajo	kasaxtanitekatl
catalán	katalantekatl
catalán	katalatl
croar	kataloa
cataluña	katalonia
eliminar	katona
suciedad	katsaktilistli
suciedad	katsaualistli
desechar	kaualtia
quemado	kauani
escorzonera	kauaxilotl
caballo	kauayo
carrusel	kauayomalakatl
caballos	kauayomej
relinchido	kauayopipitsalistli
relinchar	kauayopipitska
equitación	kauayoseualistli
caballo	kauayotl
pastura	kauayotlakuali
establo	kauayotlakuayan
terminar	kauilia
tiempo	kauitl
adverbio	kautik
aflojar	kaxani
suelto	kaxauak
casete	kaxeti
caja	kaxitl
estallar	kaxiui
castilla	kaxtilan
cigüeña	kaxtilastatl
pimienta	kaxtilchili
castellanismo	kaxtilistli
castillo	kaxtilkali
zanahoria	kaxtilkamojtli
tuna	kaxtilkuikatl
castellanos	kaxtiltekaj
castellano	kaxtiltekatl
castellanidad	kaxtiltekayotl
castellano	kaxtiltlakatl
clavel	kaxtiltsompanxochitl
clavel	kaxtilxochitl
castellano	kaxtitl
mortero	kaxtli
diecisiete	kaxtolome
trecientos	kaxtolpoali
dieciseis	kaxtolse
costal	kayamastli
sutura	keanatsinkak
québec	kebek
quezquimel	kechkemitl
quechua	kechoatl
flamingo	kecholin
papera	kechposauilistli
cuello	kechtli
camiseta	kechxikoli
sonsacar	kekeloa
sonsacado	kekeloli
atrevido	kekexkik
apenas	kemach
sí	kemaj
cuándo	keman
como	kemej
envolver	kemiloa
manta	kemitl
como	ken
cómo	kenin
cuánto	keskin
cuántos	keskintin
parar	ketsa
parado	ketsak
grulla	ketsalastatl
esmeralda	ketsalistli
hermosura	ketsalkayotl
joya	ketsalkoskatl
bello	ketsaltik
hermosura	ketsalxilistli
calcañar	ketsoli
crin	ketsontli
chal	kexkemitl
comezón	kexkistli
comerciar	ki
llover	kiaui
lluvia	kiauitl
llover	kiautia
lluvioso	kiauyo
huerto	kilimilpan
quelite	kilitl
hortaliza	kilitlan
kilogramo	kilogramo
ratonera	kimichtlapeuali
ratoncillo	kimichtontli
gigante	kinametli
muralla	kinamitl
endemoniado	kineuki
rebelador	kinextiani
quntanarroatl	kintanarooense
después	kintepan
generación	kintlakatilistli
kinguistaní	kinuistanekatl
kinguistán	kinuistania
kinguistaní	kinuistaniatl
retoño	kiotl
kiribati	kiribatia
salir	kisa
migración	kisalistli
prosperidad	kisempakkayotl
confianza	kitemachikayotl
contratar	kitoa
tomar	kitski
agarrarse	kitskia
afuera	kiuak
cristiano	kixtiani
llover	kiyaui
tallo	kiyotl
cascabel	koakuechtli
anguila	koamichin
frambuesa	koamitl
coatepec	koatepek
serpiente	koatl
ayuntamiento	koatlakan
gemelo	koatli
coahuilense	koauilatl
coahuilense	koauiltekatl
dormir	kochi
recamara	kochiantli
cansancio	kochilistli
dormido	kochini
narcotraficante	kochipanamakak
narcotráfico	kochipatilistli
levantarse	kochitleua
dormido	kochitok
soñar	kochitta
dormitorio	kochiuayan
dormitorio	kochiyan
bostezo	kochkamachalolistli
cena	kochkayotl
dormido	kochki
dormido	kochmiki
cama	kochpan
dormitar	kochtika
dormido	kochtli
desmayarse	kochuetsi
desmayo	kochuetsilistli
sirvienta	koko
enfermar	kokoa
tubo	kokojtli
picoso	kokok
recaída	kokolilochtilistli
odiado	kokoliloli
enfermedad	kokolistli
alacranes	kokolo
impacientar	kokoloa
impaciencia	kokolotl
decaimiento	kokoloyotl
revolver	kokoltia
paladear	kokomotsa
seducir	kokonauia
seductor	kokonauiak
seducción	kokonauistli
hijos	kokone
nana	kokonetlatok
enchilar	kokosiui
coco	kokotl
despedazar	kokotona
despedazado	kokotonani
hemipléjía	kokototsautli
hospital	kokoxkali
agotamiento	kokoxkayotl
paciente	kokoxki
enfermar	kokoxkui
enfermera	kokoxsiuapixki
cóctel	kokteli
margarita	koktelxochitl
abuelo	koli
acostarse	koliui
colimense	kolmatl
colimense	kolmekatl
arrugarse	kolochaui
alacranes	kolomej
valiente	kolotik
alacrán	kolotl
coloche	kolotsin
pegarropa	kolotsinkastli
torcido	koltik
abuelos	koltin
culiacán	koluakan
colhua	koluatl
cóncavo	komak
comal	komali
comadre	komantli
ahijado	komkonetl
barranco	komoli
apasionar	komoni
comores	komoriaj
compadre	kompali
conde	konde
condón	kondoni
bebés	konene
bebé	konenetl
pediatra	konepatini
pediatra	konetisitl
niño	konetontli
bebe	konetsintli
pañal	konetsotsomatli
beber	koni
congo	konko
congoleño	konkonekatl
congoleño	konkotl
recabar	konkui
recabado	konkuitli
paladar	kopaktli
incienso	kopali
pirúl	kopalkuauitl
devolver	kopilia
devuelto	kopilili
devolución	kopililistli
contestar	kopiltlajtoa
contestación	kopiltlajtoli
molde	kopinali
zafados	kopinke
zafado	kopinki
comadreja	kosamatl
amarillento	kosauak
amarillarse	kosaui
parálisis	kosiuilistli
saturno	koskatekutli
cuna	kosoli
sialorrea	kostaktli
colera	kostalauak
amarillo	kostik
palomilla	kostipapalotontli
amarillo	kostli
canario	kostototl
roncar	kotaloa
gruñido	kotalolistli
defectuoso	kotoktik
odioso	kotoliloni
playera	kotonemastli
romper	kotoni
indecisión	kototsyotl
parásito	kouili
parásito	kouilin
cabo	kouyotl
quizá	kox
faisán	koxolitli
ancho	koyauak
coyoacán	koyoakan
agujerado	koyoktik
agujero	koyoktli
cascabel	koyoli
aguja	koyolomitl
estuche	koyomikalkali
agujerado	koyonili
agujerado	koyonki
coyotepec	koyotepek
clarín	koyotototl
comer	kua
caracol	kuachalolotl
cresta	kuachikili
tocado	kuachikkili
almohada	kuachikpali
casco	kuachimali
estandarte	kuachpantli
cabeza	kuaitl
garrocha	kuakuaminaloni
ganado	kuakuauaki
orca	kuakuauemichin
vaquero	kuakuaueni
mantequilla	kuakuaueseseyotl
cuerno	kuakuauitl
vaquería	kuakuaukali
antílope	kuakuaumasatl
ganadero	kuakuaupixki
cabrón	kuakuautensonpoli
cabra	kuakuautesontli
arbolito	kuakuauton
impaciente	kualani
enojarse	kualania
enojo	kualanilistli
enojado	kualanki
bueno	kuali
traer	kualkui
magnífico	kualnesi
belleza	kualneskayotl
bondad	kualotl
bondad	kualotli
recurrido	kualtokali
bello	kualtsin
palanca	kuamitl
guanacaste	kuanakaxtli
débil	kuanakki
cardenal	kuapixtototl
camaleón	kuatapalkatl
caspa	kuatekiskitl
yelmo	kuatepostli
mutilación	kuatetsonkalistli
paraplejia	kuatlatsonkokoli
parapléjico	kuatlatsonkokoltik
trenza	kuatsontli
artesa	kuauapastli
verja	kuauchayauak
veranda	kuauchinamitl
asiento	kuauikpali
árbol	kuauitl
zueco	kuaukaktli
baúl	kuaukaxitl
barril	kuaukomitl
iguana	kuaukuetspalin
rama	kuaumaitl
raqueta	kuaumatlatl
ramoso	kuaumayo
árboles	kuaumej
boulevard	kuauojtli
porra	kuauolotli
huapango	kuaupanko
estandarte	kuaupantli
baúl	kuaupetlakaxitl
palo	kuaupitsaktli
abono	kuausoli
corcho	kuausonektli
carreta	kuautemalakatl
guatemalteco	kuautemalatl
guatemalteco	kuautemaltekatl
tronco	kuautepontli
tocador	kuauteskakali
vitrina	kuauteuilokali
alto	kuautik
ropero	kuautilmakali
aserradero	kuautiloyan
bosque	kuautlajtli
bosque	kuautlan
acuarelas	kuautlapaloni
aserrín	kuautlasoli
pico	kuautlatsakuali
alacena	kuautlauankali
águila	kuautli
madero	kuautoli
cruz	kuautolo
brócoli	kuautontsin
palenque	kuautsakuali
palo	kuauuatsali
chapitel	kuauxauilistli
ramo	kuauxiuitl
enrramado	kuauxiuyo
aserradero	kuauxoxoutlalistli
podador	kuauyektiani
hazaña	kuauyotl
tamarindo	kuaxiloxokotl
límite	kuaxochtli
inteligente	kuayolo
cerebro	kuayolotl
lento	kuechauak
cuello	kuechtli
presión	kuejsouak
estresado	kuejsouali
pasear	kuekuepa
hormiguear	kuekueyoka
encina	kuelkitl
doblado	kuelpachoali
camellón	kuemitl
traducir	kuepa
revivido	kuepayoli
revivir	kuepayolia
retorno	kuepayotl
calzada	kuepojtli
brotar	kueponi
primaveral	kueponkayotl
vuelta	kueptli
depósito	kueskomatl
coraje	kuesoli
corajudo	kuesoli
coraje	kuesolistli
lienzo	kuetilmatli
espalda	kuetlapantli
desmayar	kuetlaui
abceso	kuetlaxsauatl
piel	kuetlaxtli
prurito	kuetsokilistli
pejelagarto	kuetspalmichin
guanajuatense	kueyatlalkatl
tomar	kui
desentonar	kuikachalania
desentonado	kuikachalaniutli
consola	kuikakaxitl
corno	kuikakuakuauitl
cancionero	kuikamatl
cantante	kuikani
compositores	kuikapixke
compositor	kuikapixki
música	kuikatlamatilistli
músico	kuikatlamatini
corrido	kuikatlayeualtili
música	kuikayotl
onix	kuikuili
jaspeado	kuikuiltik
quitar	kuilia
dibujar	kuiloa
bisexualidad	kuilonyotl
oliva	kuilotl
cagar	kuitla
inodoro	kuitlakali
cuitlacoche	kuitlakochin
abono	kuitlasoli
mierda	kuitlatl
negligencia	kuitlatskopokyotl
lomo	kuitlaxiloyotl
colon	kuitlaxkoltomaktli
acaso	kuix
maja	kuuatlatsiuki
estornudar	kuxoa
estornudo	kuxololistli
li	l
chirimoya	lamatl
chirimoya	lamatsapotl
cartílago	lamitl
latino	latinotl
latino	latintekatl
latino	latintlakatl
leonés	leoni
leonés	leontekatl
lesothiano	lesotekatl
lesotho	lesotia
lesothiano	lesototl
libano	libania
libanés	libaniatl
libanés	libantekatl
liechtenstein	lichtenstania
lisboa	lisipoa
lituania	litoania
lituano	litoaniatl
liverpool	liverpol
cutícula	lotl
portugal	lusitania
portugués	lusotekatl
portugués	lusotl
luxemburgués	luxenborgiatl
mi	m
qué	ma
dizque	machamo
probar	machilia
conocimiento	machilistli
tecla	machiomiuki
código	machionekakilistli
marcar	machiotia
signo	machiotl
alfabetizar	machiotlajtoa
alfabeto	machiotlajtololistli
teclado	machiotlakuiloni
desagradable	machistli
estudio	machitilistli
señal	machiyotl
estudiante	machtiani
estudiantes	machtianimej
universidad	machtiloyan
digno	machuastik
madagascar	madagaskaria
madagascarense	madagaskariatl
delicado	maili
mano	maitl
mezquita	majomakali
islámico	majomatlakatl
castañuelas	makakapaktli
soltar	makaua
escapar	makixtia
brazo	makoli
rama	makuayotl
pentagrama	makuilamamachiotl
cinco	makuili
cien	makuilpoali
girar	malakachoa
girador	malakachoni
patín	malakaktli
ruleta	malakapatoli
rueda	malakatl
estacionamiento	malakatlayokan
disco	malaki
malasia	malasia
malayo	malasiatekatl
malayo	malasiatl
malawi	malauia
maldivas	maldiviaj
grave	maleuakuikatl
prisionero	mali
mali	malia
malinés	maliatl
torcer	malina
malinalca	malinalkatl
torcido	malinki
malinés	malitekatl
aprisionar	malkochoa
recubrimiento	malkochtli
cautiverio	malotl
malta	malta
maltés	maltatl
maltés	maltekatl
honor	maluilokayotl
digno	maluiloni
manos	mama
asustado	mamajtilok
asustado	mamajtli
venados	mamasa
escalera	mamatlatl
manosear	mamatso
manoseado	mamatsouak
manchego	manchatekatl
manchego	manchatl
manchego	manchatlakatl
aunque	manel
natación	maneloalistli
waterpolista	maneloani
andar	manenemi
mamifero	manenemini
de	mani
manzana	mantsanatl
asir	mapachoa
dedo	mapili
falange	mapiltepostli
meñique	mapilxokoyotl
marzo	martso
cervato	masakonetl
padecer	masasiui
delirio	masasiuilistli
devanado	masasiuki
garrapata	masatemitl
manso	masatlauelej
mazahua	masauatl
ciruela	masaxokotl
macedonio	masedonekatl
macedonia	masedonia
macedonio	masedoniatl
danzar	maseua
baile	maseualistli
gente	maseualtin
plebe	maseualtin
bailarín	maseuani
danza	maseuayotl
dotado	maseukatili
macizo	masik
aunque	maski
ala	masnekapali
brazalete	matemekatl
azuela	matepostli
doce	matlakome
doncientos	matlakpoali
once	matlakse
diez	matlaktli
cucharada	matlakualxopiloni
tifoidea	matlalsauatl
matlaltzinca	matlaltsinkatl
enrredado	matlaluili
conquistar	matoma
dominado	matomali
dominante	matomani
boleibol	matopetilistli
apaludir	matsatsini
incapacidad	matsikuayotl
encuadernación	matsomalilistli
brazo	matsopastli
divorciar	matuma
contagiar	maua
miedoso	mauilili
miedo	mauilistli
divertir	mauisoa
divertido	mauisoli
diversión	mauisolistli
solemnidad	mauisotl
diversión	mauisoyotl
milagroso	mauistik
divino	mauistli
engrandecer	mauitsoa
renunciar	mauitsoltelchiua
renunciado	mauitsoltelchiuani
canonizar	mauitsotia
autoridad	mauitstikayotl
miedo	maukatilistli
cobarde	maukatlakatl
cobarde	maukatlayekoani
exclamar	maukatsa
exclamación	maukatsalistli
timidez	maukayotl
mauricio	maurisia
mauritano	mauritanekatl
mauritania	mauritania
mauritano	mauritaniatl
cobarde	mautlakatl
cobardía	mautlakayotl
bifurcado	maxaltik
machetear	maxeloa
machetero	maxeloni
machete	maxelotl
suplir	maxiltia
sustituto	maxiltiani
sustituido	maxiltili
acercarse	maxitia
calzón	maxtlatl
calzón	maxtli
maya	mayatekatl
maya	mayatl
maya	mayatlakatl
mayate	mayatli
rechazar	mayaui
rechazado	mayautli
guante	mayeuatl
mayo	mayo
amén	mayumochiua
abarca	mekakaktli
conducto	mekamalakayani
ahorcar	mekania
mecapal	mekapali
alambre	mekatepostli
cuerda	mekatl
estambre	mekatlamautli
teléfono	mekatlanonotski
quesillo	mekatlatetsautli
regente	memachiliani
agaves	memej
aguamiel	menekutli
cabeza	mesontli
maguey	metl
metlapil	metlapili
metate	metlatl
metro	metro
menstruación	metsesouilistli
mes	metspouali
levantarse	meua
levantado	meuatiketski
levantamiento	meuatiketskilistli
mexicanos	mexikaj
mexiquense	mexikanekatl
méxico	mexiko
mastuerzo	mexin
mucho	miak
muchos	miaktin
abundancia	miaktiyotl
acuario	michakaxitl
pescadería	michimakoyan
pez	michin
pesca	michmalistli
michoacano	michoakanekatl
pescador	michoakani
michoacano	michoakatl
pescador	michoani
sardina	michoatsali
charal	michsakuani
secretamente	michtakauistika
caviar	michtetl
gracioso	michtik
pececillos	michtoton
mucho	miek
pedo	miexilistli
pedorro	miexini
chismoso	mijtoak
peleador	mikalini
catarina	mikasayolin
catarina	mikasoyoli
morir	miki
mortandad	mikilistli
tanque	mikiloni
mortal	mikini
testamento	mikisnauatilistli
esqueleto	mikistetl
muerte	mikistli
muerto	mikitl
mortaja	mikkatekimiloli
sepultura	mikkatepetlakali
difunto	mikkatsintli
difunto	mikki
veneno	mikoapajtli
aljaba	mikomitl
micronesia	mikonexia
ataud	mikpetlakali
cadáver	miktetl
matar	miktia
suicidarse	miktilia
matado	miktilo
panteón	miktlampan
infierno	miktlantli
infernal	miktlayotl
balacera	miktotopotstli
mil	mil
agrícola	milakayo
agricultura	milakayotl
milán	milan
sementera	mili
labrar	milia
campesino	milkitki
parcela	milpan
agricultor	milpixki
labrador	miltlakatl
recatar	mimakti
recatado	mimaktinemini
honestidad	mimatilistli
prudente	mimatini
derecho	mimatki
enjambre	mimiauamej
apicultor	mimiautekatl
finados	mimijkatsitsintin
epilepsia	mimikilistli
rollo	mimiltik
lanza	mina
lanza	minakachali
astuto	minatini
tatarabuelo	mintontli
resina	miskikopali
mezquite	miskitl
flecha	mitl
bailarín	mitotiani
danzante	mitotiki
baile	mitotili
baile	mitotilistli
danza	mitotiyotl
fiesta	mitotl
te	mits-
botón	miuki
misa	mixa
mixe	mixetl
desprenderse	mixeui
mixiote	mixiotl
parir	mixiui
parturienta	mixiuki
nebulosa	mixkoatl
disfrazado	mixpoloki
mixtecos	mixtekaj
mixteco	mixtekatl
tenebroso	mixtekomayo
apretarse	mixtilinaltia
misteriosamente	mixtlayoltika
nube	mixtli
tu	mo-
todo	mochi
todos	mochintin
siempre	mochipan
acaecer	mochiua
asustar	mojtia
callar	mokaua
silencio	mokaualistli
callado	mokauani
silencio	mokauastli
pararse	moketsa
convertir	mokuepa
acomedido	mokuini
amollar	moleua
molcajete	molkaxitl
aflojar	molonia
alumno	momachtli
librar	momakixtilia
arrojarse	momayaui
brillantez	momochkayotl
diario	momostla
diario	momostlamoxtli
diariamente	momostlatika
diario	momostlatsinka
altar	momostli
deporte	momotlalistli
estadio	momotlalkali
deportivo	momotlalo
frotar	momotsoa
despoblado	momoyauali
mosquitos	momoyo
monaqués	monakatl
contigo	monauak
necesidad	monekilistli
necesario	monekini
pensarse	monemilia
singular	monkuamoki
suegro	montajtli
entendible	mopouak
entendible	mopoualo
mozambique	mosanpikia
mozambiqueño	mosanpikiatl
mozambiqueño	mosanpitekatl
montar	mosempoua
dispuesto	mosenkauani
reunirse	mosentlalia
presuroso	mosiuiani
resucitar	moskalia
crecer	moskalti
crecido	moskaltik
mañana	mostla
acostarse	moteka
acostado	motekak
llamarse	moteneua
rezar	moteopeyotsi
rezandero	moteopeyotsiani
rezo	moteopeyotsilistli
amparado	motetoktli
disparar	motla
asqueroso	motlailtiani
rasparse	motlakichilia
sentado	motlali
asentarse	motlalia
disparo	motlalistli
tumba	motlalkontli
correr	motlaloa
corredor	motlaloani
arrodillarse	motlankuaketsa
simulado	motlapikini
conversar	motlapouia
conversación	motlapouyotl
filosofo	motlasolistlapiani
esconderse	motlatia
posar	motlauia
decoración	motlayololistli
llamarse	motoka
sencillez	motolinkayotl
pobre	motolinki
motocicleta	motomalakatl
tranquilo	motonalui
ardillón	mototli
retirado	motsakki
taparse	motsakua
pegarse	motsikoa
vengarse	motsonkui
contigo	mouan
reñido	moueteuatli
separarse	moxexeloa
goloso	moxochipoloani
ensayar	moyekolia
ensayado	moyekolili
ensayo	moyekolistli
estar	moyetstika
dios	moyokoyani
enamorado	moyoleuki
arrepentido	moyolkuepki
mosco	moyotl
ni	n
barbacoiero	nakakoyonchiuani
barbacoa	nakakoyonki
carnal	nakakualo
territorio	nakalotiloayan
carnes	nakamej
pulpa	nakamotki
carnicero	nakanamakani
carnicería	nakanamakoyan
pañuelo	nakapoualoni
sordo	nakasatsatl
reves	nakasik
agalla	nakaskolotl
oreja	nakastli
sordo	nakastsatsatl
arrogancia	nakastsonteyotl
nacatamal	nakatamali
tenedor	nakatetekki
jamón	nakatlaoyotl
carnoso	nakayo
carnudos	nakayomej
cuerpo	nakayotl
represa	nali
pasar	nalkisa
transporte	nalkixtilistli
vendible	namakatik
vendible	namako
namibia	namibia
namibio	namibiatekatl
namibio	namibiatl
esposos	namiktin
esposo	namiktli
nana	nana
madriguera	nanchantli
rerponder	nankilia
madre	nantli
maternidad	nanyotl
abrazar	napaloa
abrazador	napaloani
abrazado	napaloli
abrazo	napalolistli
napoles	napoli
nahuas	nauaj
hacia	nauak
brujo	nauali
magía	naualotl
constituido	nauatilali
constitución	nauatilalistli
ley	nauatili
derecho	nauatilmatilistli
cortejar	nauatlajtolkuepa
sonoridad	nauayotl
cuatro	naui
ridiculizar	nauilaua
jueves	nauiluitl
crucero	nauojtli
noventa	naupoalomatlaktli
cuadro	nautlateuili
nauyaca	nauyakoatl
allí	ne
bañera	nealtikaxitl
baño	nealtimaloyan
junta	nechikali
asociado	nechikoli
conjunto	nechikolistli
purgatorio	nechipaualoyan
respiración	neijiyotilistli
respiradero	neijiyotiloni
antojería	neikoluayan
sudar	neitonalia
sudoración	neitonalistli
encomienda	neixiptlatilistli
copiadora	neixkuitilamakali
discordia	neixmakilistli
disfraz	neixpololistli
osado	neixtlapaloli
osadía	neixtlapalolistli
ese	nekaj
desmigajado	nekakayachilili
batalla	nekalilistli
mudanza	nekalpatlalistli
silencio	nekaualistli
reliquia	nekaukatl
relicario	nekaukayotl
voluntad	nekilistli
humildad	neknomatlikayotl
dolor	nekokolistli
alteración	nekomonilistli
bolos	nekuaumotlalistli
puertorriqueño	nekuiltonolakalkixoani
costarricense	nekuiltonolanauatl
costarricense	nekuiltonolanauatlakatl
conocimiento	nekuitilistli
maguey	nekumetl
pulque	nekuoktli
pastel	nekupantsin
conserva	nekutlachiuali
turrón	nekutlatepitsauali
miel	nekutli
verdad	neli
cuchara	neloani
batimiento	neloayotl
faja	nelpiloli
cierto	neltik
probable	neltililoni
probablemente	neltililostika
predicador	neltilistemachtiani
verdad	neltilistli
credo	neltokilistli
fe	neltokokayotl
creyente	neltokoni
raíz	neluatl
arraigado	neluayo
arraigar	neluayoltia
raíz	neluayotl
propósito	neluilistli
arrepentimiento	nelyolkokolistli
enseñar	nemachtia
maestro	nemachtiani
aula	nemachtilkali
escuela	nemachtiloyan
alumno	nemachtlapouki
conocimiento	nemachtokilistli
serio	nemaluali
discreción	nemataliskayotl
cautela	nematilistli
sensible	nematini
sentido	nematistli
sentido	nematiuani
delicado	nematkatili
urbanidad	nematkayotl
divorcio	nematumalistli
miedo	nemautilistli
miedoso	nemautini
satiriasis	nemekatilistli
camisa	nemetsuilistli
habitar	nemi
testamento	nemikisnauatilistli
casamiento	nemiktilistli
especular	nemilia
avance	nemililistli
historia	nemiliskayotl
mito	nemilistlatolotl
vida	nemilistli
revolcado	nemimiloli
revolcadero	nemimiloyan
jabalina	neminalistli
habitante	nemini
biología	neminilistlamatilistli
biologo	neminilistlamatini
aceleración	nemosiuilistli
agonía	nemosiuilistli
desamor	nenekilistli
disolver	neneloa
caminar	nenemi
pasaje	nenemili
pensar	nenemilia
caminata	nenemilistli
caminante	nenemini
pasajero	nenenki
lengua	nenepili
comparar	neneuila
igualdad	neneukayotl
semejante	neneuki
rebelado	nenextili
antigüedad	neneyotl
vivenda	nenkayotl
inutilidad	nenyotl
allí	nepa
nepalés	nepaltekatl
centro	nepantla
diversidad	nepanyotl
nepalés	nepatl
desconfiar	nepatla
desconfiado	nepatlali
desconfianza	nepatlalistli
desconfiado	nepatlautli
abatimiento	nepilotiuechilistli
cuaresma	nesaualispan
penitencia	nesaualistli
determinación	nesemixnauatilistli
concejo	nesentlalilistli
ligar	neseseui
ligadura	neseseuilistli
ligue	neseseuilistli
ligado	neseseutli
reposo	neseuilistli
aparecer	nesi
aparecido	nesitli
cordura	neskalikayotl
significar	neskayotia
significado	neskayotilistli
vomito	nesotlalistli
quedar	nestika
ocupado	netekipachilili
gimnasio	netekoliskoyan
esperanza	netemachikayotl
adoración	neteotilistli
adoptado	netepitsintili
adopción	netepitsintilistli
amparo	netetoktilistli
gramática	netlajtolmachitilistli
fidelidad	netlakanekilistli
fiel	netlakanekini
infidelidad	netlakanekolistli
infiel	netlakanekoni
dieta	netlakualistli
constancia	netlakuauketsalistli
reclamación	netlakuepilistli
cuidado	netlakuitlauilistli
cuidadoso	netlakuitlauini
humillación	netlalchitlasalistli
humillante	netlalchitlasoni
concepción	netlalilistli
legua	netlaloli
angustiar	netlamachia
angustiado	netlamachiliani
angustia	netlamachilistli
simulador	netlapikiani
obligación	netlatlalilistli
voto	netoli
indigencia	netolinistli
consultado	netolnotsali
profesión	netoltialistli
solana	netoniloyan
amparo	netontlilistli
pañuelo	netsomiloni
venganza	netsonkuilistli
ordenar	neuatia
tardanza	neuejkaualistli
viviente	neuemini
emparejar	neuiuilia
lejía	nexatl
derribado	nexetinili
avaro	nexikoli
envidia	nexikolistli
navaja	neximalistli
barbería	neximaloyan
lobos	nexkoyomej
nixtamal	nextamali
concreto	nextetl
gris	nextik
creatividad	nextilistli
mostrado	nextilo
diseño	nextiyotl
enemistad	neyaotlalistli
gimnasia	neyekochiualistli
atleta	neyekoni
hipocresía	neyektokilistli
conciencia	neyoliximachilistli
confesionario	neyolmelaualoni
considerado	neyolnonotsali
consultar	neyolnotsa
consulta	neyolnotsalistli
reconocer	neyolomaxi
reconocido	neyolomaxili
reconocimiento	neyolomaxilistli
arrepentimiento	neyoltekipacholistli
duda	neyoltsonalistli
voy	niau
hurtar	nichteki
tirano	nijikoltiani
tiranía	nijikoltilistli
porque	nik
aquí	nikan
nicaragüense	nikanauatl
nicaragüense	nikanauatlakatl
confirmado	nikchikauak
celebrar	nikitoa
comunión	niknoselistli
entrega	niktemaktli
cuanto	nikuiko
hola	niltse
este	nin
sentido	ninauitokak
acaudillar	nitemana
micrófono	nitlajtoaloni
mi	no-
además	no
grana	nochestli
todo	nochi
todos	nochintin
siempre	nochipan
todos	nochtin
tunar	nochtlan
tuna	nochtli
también	noijki
también	noiuan
además	noiuki
mientras	noka
siempre	nonchipa
esos	nonke
derramarse	nonoki
diálogo	nonotsalistli
nopal	nopali
noruego	norvegiatl
noruego	norveginekatl
comulgar	noselilia
o	noso
llamado	notsalo
conmigo	nouan
absoluto	nouanyotl
dondequiera	nouiampa
noviembre	noviembri
también	noyuki
o	o
avenida	ochpantli
vereda	ojpitsaktli
balcón	ojtlachialotl
otate	ojtlatl
peregrinación	ojtlatokalistli
peregrino	ojtlatokani
camino	ojtli
caminante	ojtokak
aún	ok
futuro	okachiuali
chivo	okichkuakuautensontli
viuda	okichmikki
jovencito	okichpiltsintli
cabrón	okichtensonpoli
chivo	okichtensontli
masculino	okichtik
varonil	okichtikautli
hombres	okichtin
soltera	okichtlanki
hombre	okichtli
proeza	okichyotl
vinatería	oknamakoyan
adelante	oknepan
pavilo	okoikpayolotl
linterna	okokalotl
piñón	okosenyolotli
pinar	okoyotl
otro	okse
otro	okseki
otros	oksekintin
vino	oktli
octubre	oktubri
virgen	okuelichpoktli
gusano	okuili
gusano	okuilin
barranca	okyatl
hule	oli
hule	olin
mover	olinia
máquina	olinki
emoción	olinyotl
baqueta	olmaitl
llanta	olmalakatl
redondo	ololtik
olote	olotl
omaní	omantekatl
dos	ome
martes	omeiluitl
doblar	omelia
bicicleta	omemalakatl
dieresis	ometliltetl
farsante	omeyolo
dudar	omeyoloa
huesero	omiketsani
carroñero	ominakatini
costilla	omisikuili
hueso	omitl
nardo	omixochitl
allá	ompa
cuarenta	ompoali
cincuenta	ompoalomatlaktli
beber	oni
ahí	onkan
tabasqueño	onoualkatl
tabasqueño	onoualtekatl
sitio	onouayan
acompañante	ontekauani
sobrenombre	ontetokaitl
segundo	onto
mil	ontsonmatlakpoali
ochocientos	ontsontli
crecimiento	onyalistli
jaguares	ooselo
según	opan
zurdo	opochmimatki
izquierda	opochtli
oceanía	oseania
bravo	oselo
cebra	oselokauayotl
bravos	oselomej
jaguar	oselotl
valentía	oseloyotl
gorila	osomatl
mono	osomatli
sagrario	ostiakali
minero	ostotakani
cueva	ostotl
cavernoso	ostotla
mineral	ostoyotl
digerido	otemok
migración	otlakalistli
otomí	otomitl
mandarino	otonlalaxkuauitl
mandarina	otonlalaxtli
retorcido	otsilik
encinta	otstli
guacal	ouakali
peligro	ouilistli
desastre	ouitepanyalistli
desgranado	oyali
pe	p
pintar	pa
pasear	pachialoa
golpear	pachilia
chupar	pachisijina
arrugado	pachisijini
sumirse	pachiui
desnivel	pachiuitl
sumido	pachiutli
pequeño	pachtik
correr	paina
mercurio	painaltli
atleta	painalton
herbolario	paiximatki
herbolario	paiximatkiyotl
salud	pakayelistli
felicidad	pakiliskayotl
felicitación	pakilistli
feliz	pakini
pakistaní	pakistanekatl
pakistán	pakistania
pakistaní	pakistaniatl
psicología	pakkayematilistli
psicólogo	pakkayematini
contento	pakki
gustar	paktia
pacifico	paktinemi
vigor	paktinemilistli
alegría	paktli
papalote	palalotli
fétido	palanki
herida	palaxtli
palestino	palestinekatl
palestina	palestinia
palestino	palestiniatl
ayudar	paleuia
pintura	pali
hospedar	palkoui
serpentina	palmekatl
gustar	paloa
alfombra	palpetlatl
reciente	paltik
tamarindo	palxokotl
paliacate	palyakatl
banderín	pamitl
abanderado	pamitlani
para	pampa
panamá	panama
farmacéutico	panamakak
panameño	panamatl
descubierto	panitlasatl
bandera	panketsali
cruzar	pano
penacho	pantekatl
alieneación	pantilistli
abanderado	pantlani
abanderar	pantlania
abanderamiento	pantlanilistli
pan	pantsin
deshilado	papachtli
felizmente	papakilistika
relamido	papaloni
mariposa	papalotl
papalote	papalotli
aletear	papantlaka
enmarañar	papasoloa
farmacéutico	papiani
paraguay	parauaria
paraguayo	parauariatl
paraguayo	parauatekatl
paris	parisi
enmarañar	pasoloa
enmarañado	pasoltik
herrar	patilia
sanidad	patilistli
costo	patioyotl
valor	patiyotl
valer	patiyoua
cambiar	patla
aplastarse	patlachiua
plano	patlachtik
treque	patlali
volador	patlani
vuelo	patlanilistli
amplio	patlauak
ensanchado	patlautli
medicina	patli
dado	patoli
albur	patolsasanili
tablero	patoluapali
blando	patsik
exprimir	patska
aplastar	patsmiki
apretar	patsoa
magullado	patstik
librillo	patstli
ceñidor	paxatl
desechar	payanka
desecho	payanki
químico	payelisyo
químico	payelisyomitili
química	payelisyotl
humillarse	pechtika
calentador	pepechtotoniloni
levantar	pepena
recogido	pepenali
levantamiento	pepenalistli
recogedor	pepenaloni
pepenador	pepenani
petates	pepetla
centella	pepetlakatl
relumbrar	pepeyoka
relumbrado	pepeyokak
ataque	petlachiuilistli
atacar	petlachiuki
caja	petlakali
cromado	petlaktik
cromar	petlakui
petatearse	petlamiki
carpeta	petlasoli
ciempiés	petlasolkoatl
petate	petlatl
destapado	petlauak
destapador	petlaualoni
bruñido	petsoli
brillante	petstik
comienzo	peualistli
pionero	peuani
guardarse	pia
presente	piali
tisis	piasketsalistli
inventar	piki
macizo	pikki
infante	pilatl
arrugarse	piliui
colgar	piloa
colgaje	piloli
distinguido	piltekatl
nobleza	piltikayotl
niño	piltontli
hijos	piluan
engendrar	piluatia
alumbramieto	piluatiyotl
acrecentar	piluilia
pimería	pimapan
pinacate	pinakatl
avergonzar	pinaua
avergonzado	pinauali
vergüenza	pinaualistli
vergonzoso	pinauani
pollos	piomej
nobles	pipil
cubierta	pipilkali
nobles	pipiltin
niños	pipiltoton
bramar	pipitska
chillador	pipitski
bramido	pipitskitl
helicóptero	pipiyolkali
tatarabuela	piptontli
devastado	pisili
devastar	pisiloa
devastación	pisiltilistli
devastado	pisiltli
recolectar	piskani
delgado	pitsaktik
pito	pitsali
delgado	pitsauak
lenteja	pitsauasetl
cintura	pitsauautli
delicadeza	pitsauayotl
lechón	pitsokonetl
piara	pitsopankali
cosechar	pixka
cosecha	pixkalistli
cosechador	pixkalteki
guardián	pixki
cosecha	pixkitl
administrar	pixkua
abrir	poa
cardado	pochinki
roble	pochotl
comerciante	pochtekatl
comercio	pochtli
humo	poktli
humeante	pokyo
aliento	pokyotl
grueso	pol-
grueso	poli
desaparición	poliuilistli
desaparecido	poliuini
pulque	poloki
señalado	pololisnetsayotili
perdón	pololokayotl
polonia	polonia
polaco	polontekatl
polaco	polontlakatl
polaco	polotl
ponche	pontsin
incensario	popochkaxitl
aromatizante	popochtli
humeante	popokak
chimenea	popokalkisani
asfixiarse	popokmiki
pipa	popokuaukomitl
despoblado	popoliuki
champaña	popotsoktli
criticar	popoua
criterio	popouayotl
barbechar	popoxoa
glotonería	posatilistli
glotón	posatini
inflamar	posaua
inflamación	posauatl
inflamado	posautik
quebradizo	posteki
quebrarse	posteki
quebrado	postektli
derramar	potlania
heder	potoni
apeste	potonilistli
apestoso	potoniyo
potosino	potositekatl
potosino	potositl
acumular	potsoa
pozole	potsolatl
espuma	potsonali
ebullición	potsonilistli
cuenta	pouali
tribunal	poualtlajtoyan
calculadora	poualuastli
milenio	poualxiutilistli
administrador	pouani
contador	pouki
lila	poxtik
barriga	poxtli
salado	poyek
terciopelo	puchinchi
qui	q
rri	r
radiotelescopio	rradioiluikali
radio	rradiotl
potro	rrejotl
rinoceronte	rrinoserontli
riojano	rrioxanekatl
riojano	rrioxatl
roma	rroma
rumano	rromanekatl
rumania	rromania
rumano	rromaniatl
rwandés	rrouandatl
rwanda	rrouandia
rwandés	rrouantekatl
rusia	rruxia
si	s
zi	s
acarrear	saka
aridoamérica	sakachichimekapan
acarreo	sakalistli
forrajero	sakamiyotl
mogote	sakamoli
cargador	sakani
segador	sakapik
segadora	sakapiloni
zacatecano	sakatekatl
paja	sakatl
meseta	sakatlan
teporingo	sakatochin
sarnoso	sakauatini
zacahuil	sakauili
mediano	sakuali
añadirse	saliui
coyuntura	saliuyantli
dilatado	samauki
solo	san
zambia	sanbia
zambiano	sanbiatekatl
zambiano	sanbiatl
vago	sanemini
solamente	sanitsinka
solamente	saniyo
moderado	sankexkin
abortado	sanoli
santa	santa
finalmente	santepan
santiago	santiago
mediano	santleko
santo	santo
foráneo	sanuitstli
mismo	sanyeno
brebaje	sasaltik
resignar	sasamaua
pálido	sasamauak
chiste	sasamijtoak
cascabel	sasanakali
tráquea	sasanaktli
relato	sasanili
adivinanza	sasanilistli
mitología	sasanilyotl
definitivamente	satepan
finalmente	satlatsonko
telaraña	sauali
sarnoso	sauatik
grano	sauatl
contrato	sayanalistli
un	se
voluntad	sealistli
pliego	seamatl
hebra	seikpatl
lunes	seiluitl
algún	seki
unos	seki
algunas	sekimej
cierto	sekintin
juntos	sekkan
particular	seknikiski
refrigerio	sekotlasalistli
septiembre	sektiembri
enfriamiento	sekuilistli
solo	sel
selchelles	selcheyiaj
inmaduro	selik
chilacayote	selikayotli
esencia	selistli
celta	seltatl
celta	seltekatl
tierno	seltik
vocal	seltikakistli
ternura	seltikayotl
celta	seltlakatl
península	semakoltlalpan
acaparar	semana
comercio	semanaktli
acaparado	semanali
acaparamiento	semanalistli
acaparador	semanani
universo	semanauak
geografía	semanauaktilistli
física	semanauatilistli
físico	semanauatini
mundo	semanauatl
sencillo	semani
sencillamente	semanilistika
sencillez	semanilistli
semana	semaniluitl
sencillamente	semanka
eterno	semankakyeni
eternidad	semankayotl
conformar	semati
conformidad	sematilistli
unidad	semaxkayotl
agradable	semele
duradero	semiak
perdurable	semikak
helado	semikki
tarea	semiluitekitl
político	semitki
política	semitkimatilistli
cucharada	semixkoli
racimo	semocholi
mazorca	semolotl
superar	sempanauia
renglón	sempantli
zempoala	sempoalan
veinte	sempoali
treinta	sempoalomatlaktli
cempasúchuil	sempoalxochitl
multiplicar	sempoua
múltiplo	sempouali
veinte	sempouali
multiplicación	sempoualistli
tierra	semtlaltikpak
internet	semtlaltikpamatlatl
terrestre	semtlaltikpatl
completo	sen
senegal	senegalia
senegalés	senegaltekatl
senegalés	senegatl
trago	senekomonili
termino	senetlaloli
atletismo	senetlalolistli
meridiano	seniktlalpan
muy	senka
bocado	senkamatl
raro	senkamochiuak
disponer	senkaua
enteramente	senkiska
entero	senkistli
silo	senkolotl
escarmentar	senmixnauatia
escarmiento	senmixnauatilistli
coro	senseknitla
res	sentekuakuaue
completamente	sentetika
absoluto	sentetl
completo	sentetl
unión	sentilistli
gotera	sentlachipintli
bloque	sentlakotontli
copla	sentlakxitl
fantasma	sentlalpachtontli
yunta	sentlamantiki
articulo	sentlamantli
manada	sentlamatin
rebaño	sentlamayolkatl
consumir	sentlamia
consumido	sentlamiali
consumo	sentlamialistli
pedrada	sentlamotetl
fondo	sentlani
eje	sentlasotl
sorbo	sentlatektli
paso	sentlaxitl
profundidad	sentlinayotl
innumerable	sentson-
constelación	sentsonuitsauak
pieza	sentsotl
omnipotencia	senualistli
aniversario	senuauetilistli
familiaridad	senyeliskayotl
familia	senyelistli
familiar	senyelo
piñón	senyolotli
nuez	senyoyotl
unido	sepanka
unir	sepanka
estrofa	sepantlakuikali
nieve	sepayali
heladera	sepayaloni
nevar	sepayaui
nieve	sepayauitl
nevada	sepayautli
frío	sesek
refrigerador	sesekali
friolento	sesekmikini
coro	seseknitla
refrigerar	sesekotlasa
refrigeración	sesekotlasalistli
refrigerador	sesekotlasaloni
iceberg	sesekpan
tundra	sesektlan
enfriar	seselia
fresco	seselik
enfriamiento	seselistli
diario	sesemiluitika
señalado	sesemotli
cada	sesen
genero	sesentlamantli
espantar	sesepakatikisa
espanto	sesepakatikisalistli
riguroso	sesepaktik
espantoso	sesepatik
calmado	seseuilo
enfriarse	seseya
seboso	seseyo
adicionar	setilia
unidad	setilistli
hielo	setl
líquido	setlachipinili
sombra	seualotl
helar	seuetsi
edad	seueuetilistli
apagar	seui
descanso	seuilistli
entelerido	seuilok
helada	seuitsitli
sevilla	sevilan
ano	sexiuitl
tuétano	seyotl
cansado	siamikki
cansado	siammikki
sopa	siauali
sopear	siauaya
cansar	siaui
cansado	siauik
cansancio	siauistli
abuela	sijtli
caracol	sili
caracol	silin
zimbawe	sinbaue
singapur	singapuria
labio	sipetl
siria	siria
sirio	siriatekatl
sirio	siriatl
circo	sirko
estrella	sitlali
estrella	sitlalin
astrólogo	sitlalmatini
cometa	sitlalmina
aerolito	sitlalminatetl
estrellado	sitlalo
galaxia	sitlalpopokak
zitlaltepec	sitlaltepek
astronauta	sitlalteposakalteyakanki
astrología	sitlaltlamatilistli
planeta	sitlaltsitsimitl
perra	siuachichi
amiga	siuaikniutli
bisnieta	siuaikutontli
perra	siuaitskuintli
prima	siuaixoyutli
mujeres	siuaj
zapatilla	siuakaktli
vecina	siuakalpolpoui
yegua	siuakauayotl
hijas	siuakokone
ahijada	siuakomkonetl
condesa	siuakonde
hija	siuakonetl
sobrina	siuamachtli
pantaleta	siuamaxtli
viudo	siuamikki
nuera	siuamontli
bruja	siuanauali
corsé	siuanelpiloli
maestra	siuanemachtiani
muñeca	siuanenetl
lesbiana	siuaokichtik
lesbianismo	siuaokichyotl
reina	siuapilajtokatsintli
doncella	siuapili
doncellas	siuapiltin
guerrerense	siuatekatl
osa	siuatekuanotl
maestra	siuatemachtiani
monja	siuateopixki
diosa	siuateotl
criada	siuatetlanamiuki
femenino	siuatik
ginecólogo	siuatisitl
mujer	siuatl
gitana	siuatlachixki
concubinas	siuatlaixnamike
reina	siuatlajtoani
dama	siuatlakatsintli
soltero	siuatlanki
maja	siuatlatsiuki
niña	siuatontli
guajolota	siuatotoli
niñas	siuatoton
suegra	siuauexiutli
prostituta	siuauiani
muñeca	siuaxolotl
santa	siuayektli
mujeriego	siuayo
feminidad	siuayotl
axila	siyakatl
cansar	siyaui
lodo	sokitl
enlodar	sokiuia
enlodado	sokiuili
enlodado	sokiyo
hondureño	solatl
envejecer	soloa
envejecido	solotik
hondureño	soltekatl
gastado	soltik
basurero	solyokan
ensañar	soma
coraje	somali
somalia	somalia
somalí	somaliatl
somalí	somaltekatl
bofo	sonetik
astillar	soneui
astilla	soneuili
zumbido	sosolokalistli
inmundicia	sotl
zotol	sotolin
dátil	soyakapolin
palma	soyatl
palmar	soyatlan
sudán	sudania
sudanés	sudaniatl
sudanés	sudantekatl
surinam	surinamia
ti	t
tailandés	tailandatl
tailandia	tailandia
tailandés	tailantekatl
taiwanés	taiuantekatl
padre	tajtli
papá	tajtsin
tamaulipas	tamajolipan
tamaulipeco	tamajolipanekatl
tamaulipeco	tamajolipatl
tamal	tamali
sapo	tamasoli
sapo	tamasolin
acampanado	tanatik
tanzano	tansanekatl
tanzania	tansania
tanzano	tansaniatl
taoísmo	taoyotl
arroparse	tapachkentia
enmarañar	tapasoloa
pañoso	tapauak
esfera	tapayoltik
camilla	tapechtli
tayikistán	tayikistania
éxito	teaasistli
tormento	teamanalistli
don	teaxkatili
desmenuzado	teayayanoli
esperado	techiali
espera	techialistli
venta	techiankali
gasolina	techiauakatlatiloli
petróleo	techiauakayotl
esperanza	techiayotl
alcohol	techichik
seísmo	techikuasentekak
alcohólico	techiuikki
participante	techmotlaliani
apropiarse	techtia
privilegiado	teiknelili
privilegio	teiknelilistli
privilegio	teikneliloni
sociabilidad	teikniuyotl
clemencia	teiknoittalistli
piadoso	teiknoittani
empobrecido	teiknotilili
empobrecimiento	teiknotililistli
misericordia	teiknottalistli
bienechor	teiktliani
cárcel	teilpiloyan
encarcelamiento	teilpiloyatilistli
encarcelado	teilpiloyatli
reclamar	teiluia
reclamado	teiluili
reclamo	teiluilistli
escandaloso	teisautli
terrible	teisouik
temor	teitsautilistli
elección	teixkisalistli
engañosamente	teixkuepalistika
falsificación	teixkuepalistli
falsedad	teixkuepayotl
ingrediente	teixnakimikili
resistente	teixnamikini
despedido	teixnauatilili
despedida	teixnauatilistli
delantatero	teixpak
proponer	teixpantilia
oftalmólogo	teixpatini
cerveza	teixuinotl
tú	tej-
huarache	tekaktli
ermita	tekaltontli
burlón	tekamauitl
persona	tekatl
sobrepasar	tekaua
engaño	tekelolistli
engaño	tekilolistli
encomendado	tekimaktli
preocuparse	tekipachoa
semanero	tekipani
mantener	tekipanoa
mantenido	tekipanoli
oficio	tekipanolistli
duro	tekiski
trabajador	tekitini
autoridad	tekiuak
autoridades	tekiuake
salitre	tekixkitl
salitroso	tekixkiyo
desempleado	tekixtili
desempleo	tekixtilistli
sirvienta	tekiyo
economista	tekiyotiani
negocio	tekiyotl
homicida	tekmiktiani
tabano	tekmilotl
tecnológico	teknoloyo
hospedado	tekochitilili
adormecimiento	tekochtekalistli
adormecido	tekochtektli
arrollado	tekochtlali
sepulcro	tekochtli
dueños	tekojtin
lesión	tekokolistli
tamborcito	tekomalpili
percusión	tekomatl
exitado	tekomoni
pellizco	tekotonalistli
bramar	tekoyoa
aullido	tekoyolistli
juzgado	tekpan
ordenar	tekpana
dominante	tekpani
dominar	tekpania
dominado	tekpanili
xílex	tekpatl
hidalgo	tekpili
cortesía	tekpiltikayotl
caracola	teksispitsali
patear	tektelisa
postre	tekuakualistli
baboso	tekualakkisani
mounstro	tekualnesi
santificado	tekualtilili
osezno	tekuanokonetl
bautisterio	tekuatekiloyan
mutilado	tekuatetsonkatli
aguamiel	tekuatl
fiereza	tekuayotl
acosado	tekuekuechmiktoani
envolver	tekuia
estatua	tekuikuili
homosexual	tekuiloni
enriquecedor	tekuiltononi
sello	tekuiluastli
cornada	tekukuauilistli
cofradía	tekuteokayotl
cardenal	tekuteopixki
diputado	tekutlajto
diputación	tekutlajtolistli
señor	tekutli
dignidad	tekuyotl
pero	tel
detestar	telchiua
embarazada	teleltilistik
embarazo	teleltilistli
parar	telketsa
parado	telketsaki
parado	telketsali
esófago	telkoyonkatl
lagrimal	telkuichili
redaño	telmatl
aro	telolotl
bodoque	telolotli
universidad	telpochkali
preparatoria	telpochpan
jovenes	telpochtin
joven	telpochtli
jovenes	telpokamej
joven	telpokatl
juventud	telpokayotl
confiar	temachi
confiarse	temachia
maestro	temachtiani
mestros	temachtianimej
doctrina	temachtili
escuela	temachtiloyan
concreto	temachtli
confianza	temachtli
confianza	temachyotl
dar	temaka
dador	temakak
liberador	temakixti
redentor	temakixtiani
traidor	temaktekauani
delatar	temaktia
delatado	temaktili
donación	temaktilistli
entregado	temaktli
rueda	temalakatl
camioneta	temalakaxitl
honda	temalatl
supuración	temalatli
absceso	temalotl
terrible	temamaiutini
escalera	temamalatl
banqueta	temamatli
terrible	temamauti
terrible	temamautik
terrorista	temamautini
temeroso	temamautli
defendido	temanauili
telecomunicación	temasilmatilistli
temascal	tematskali
terapia	tematstisiyotl
divorciado	tematumali
contaminado	temauali
contaminante	temauani
deshonrado	temauispololi
deshonra	temauispololistli
enloquecimiento	temauitilistli
honrado	temauitsotili
honra	temauitsotl
contaminado	temauki
contagio	temautilistli
susto	temautilistli
enloquecido	temautli
atestiguado	temelauani
soñar	temiki
homicida	temiktiani
asesino	temiktiloni
rastro	temiktlan
venenoso	temiktli
hermano	temini
cartucho	temitl
caer	temo
pendiente	temoayan
mortero	temokaxitl
descargar	temolia
descendimiento	temolistli
embarazada	temosiuilistli
desarrolllo	temoskalistli
concurrencia	temouatl
descender	temouia
beso	tempitsolistli
gemir	tena
otólogo	tenakaspatini
ensordecido	tenakatstilili
gemido	tenalistli
atributo	tenamaktli
besar	tenamiki
encontrado	tenamiki
encuentro	tenamikilistli
topado	tenamikki
muralla	tenamitl
contestador	tenankiliani
respondido	tenankilili
respuesta	tenankilistli
talud	tenantli
filoso	tenatkitl
abrazo	tenauatekilistli
licenciado	tenauatilili
defensa	tenauatilistli
desafío	tenaukauilistli
deshilar	tenchaya
deshilado	tenchayatli
deshilado	tenchayauak
hocico	tenchimali
dadivoso	tenemaktiani
argamasa	tenesokitl
desayunar	tenisa
desayuno	tenisalistli
almuerzo	tenisaloni
afilado	tenitstik
tenis	tenix
tenis	tenixlistli
relieve	tenkauali
lleno	tenki
saliva	tenkualaktli
veneno	tenkualaktli
jefe	tenkutli
real	tenkuyotl
tenochca	tenochkatl
disciplina	tenonotialistli
relacionado	tenonotsali
oración	tenonotsalistli
relator	tenonotsani
desenfrenar	tentlauelia
desenfrenado	tentlauelilok
amontonado	tentok
amontonar	tentoka
confundir	tentsakua
confusión	tentsakualistli
confuso	tentsakuani
barbado	tentsonyo
vuelto	tentsouki
fama	tenyilistli
famoso	tenyo
famoso	tenyotekatl
fama	tenyotl
biblia	teoamoxtli
santiguar	teochiua
domingo	teoiluitl
templo	teokali
capilla	teokalkuitlapili
sacristán	teokalpixki
elefantitis	teokokolistli
rosario	teokuaumekatl
alabanza	teokuikatl
oropel	teokuitlamatl
atesorar	teokuitlapia
tesoro	teokuitlapiali
tesorería	teokuitlapiayotl
joyería	teokuitlapitskali
tesorero	teokuitlapixki
evangelizar	teomachtia
evangelio	teomachtilistli
ahijado	teopankixtipili
ermita	teopantli
monasterio	teopixkali
sacerdotes	teopixke
padre	teopixki
papa	teopixtlajtoani
ungido	teosali
teocintle	teosentli
comadre	teotenantli
compadre	teotetajtli
energía	teotilistli
teotihuacano	teotiuakatl
consagrar	teotiya
dios	teotl
oración	teotlajtoli
tarde	teotlak
sacristán	teotlakipixki
tarde	teotlaktli
tardío	teotlakuili
tardío	teotlakyo
fanático	teotlalnoteki
idolo	teotontli
turquesa	teoxiuitl
sagrado	teoyojtika
dios	teoyokoyani
madrina	teoyonantli
padrino	teoyotajtli
divinidad	teoyotl
gobernación	tepacholisyotl
aplastar	tepachoua
agradable	tepak
favor	tepaleuilistli
alfarero	tepalkatekatl
bastardo	tepalkonetl
vestigio	tepaltlajtoli
arqueólogía	tepaltlajtomatilistli
arqueólogo	tepaltlajtomatini
pared	tepamitl
vecindad	tepanamikilistli
victoria	tepanaualistli
victorioso	tepanauani
vencedor	tepanaui
vencido	tepanauili
corral	tepanchinamitl
dominar	tepani
tabique	tepanpitsauak
asistente	tepantilo
abogado	tepantlajtoani
elevador	tepantlakok
desastroso	tepanyalo
lamedor	tepapaloani
lamida	tepapaloani
lamedura	tepapalolistli
curandero	tepatiani
curanderos	tepatike
curandero	tepatiki
sanado	tepatili
herrante	tepatiliani
herrado	tepatilili
tepache	tepatsin
vencedor	tepauaniani
verbena	tepechin
calzada	tepektli
favor	tepeleuilistli
cerros	tepemej
robalo	tepemichin
alpinismo	tepetilistli
montañés	tepetlakatl
serrano	tepetlakayo
sierra	tepetlan
tepetate	tepetlatl
valle	tepetsalan
duranguense	tepeuakatl
conquistador	tepeuani
duranguense	tepeuatekatl
desbarrancar	tepexiuia
desbarrancado	tepexiuik
alpino	tepeyo
microscopio	tepitonmachioli
humillarse	tepitonoa
chiquito	tepitsin
ladera	tepixtlan
espermatozoide	tepokatsintli
eyaculado	tepolatilili
pene	tepoli
condón	tepolpopolochtli
submarino	teposakamitl
plancha	teposamatl
caldera	teposapastli
cañón	teposapiluamina
eslabón	teposchikoli
herrero	teposchiuki
jeringa	teposchiupatli
pesa	teposetili
lima	teposichikoni
tren	teposkalmimiloli
coche	teposkalnejnenki
platillos	teposkaxpechtli
botes	teposkaxtin
trompeta	teposkikistli
anzuelo	teposkololi
corneta	teposkuakuauitl
sacacorchos	teposkuaunektli
robot	teposkuayolotl
robótica	teposkuayoloyotl
sincel	teposkuiloni
enrejado	teposmachantli
espadachín	teposmakuauchiuki
espada	teposmakuauitl
esgrima	teposmakuautilistli
metro	teposmalakakaltetl
carcacha	teposmalakasoli
auto	teposmalakatl
aparcamiento	teposmalakatlalyokan
cochera	teposmalakauayan
alambre	teposmekatl
proyectil	teposmitl
barandal	teposojtli
punzón	teposomitl
avión	tepospatlanki
batidora	tepospatskaloni
herrería	tepospitsauayan
pistola	teposteixiumitl
puñal	teposteixmitl
triturador	teposteki
daga	tepostemaixiliuani
cuchillada	teposteuitekili
mecánico	tepostiani
pasado	tepostik
bala	tepostlachtli
espátula	tepostlakoloni
atril	tepostlakoni
varilla	tepostlakotl
impresor	tepostlakuilo
imprimir	tepostlakuiloa
impresión	tepostlakuilolistli
metralla	tepostlakuimitl
tenazas	tepostlaloni
parrilla	tepostlapechtlatsaloni
campanario	tepostlapilkoyan
saxofón	tepostlapitsali
abrelatas	tepostlapoani
candado	tepostlasakualoni
chatarra	tepostlasoli
martillo	tepostlateuiloni
herramienta	tepostlatkitl
dedal	tepostlatsomaloni
yunque	tepostlatsonaloni
ballesta	tepostlauilistli
aballestar	tepostlauitoloa
estufa	tepostlekuili
metal	tepostli
avioneta	tepostotontli
avión	tepostototl
curva	tepostsotik
espuela	teposuitstli
tijeras	teposximani
granada	teposxiuki
cacerola	teposxoktli
motor	teposyolotl
jorobado	tepotsotli
tepojal	tepoxali
posada	teseliloyan
diabólico	teselo
demonio	teselotl
plazo	tesentlayekoltilistli
aliviado	teseuili
alivio	teseuilistli
moler	tesi
fatigado	tesiautli
alojador	tesiliani
hospedado	tesilili
albergue	tesililoyan
alojamiento	tesilistli
quejido	tesiuitilistli
espejo	teskatl
flebotomía	tesokistli
yeso	tesokitl
lanceta	tesouani
padres	tetajnantli
piedras	tete
proximidad	tetech
comprometer	tetechninokaua
compromiso	tetechtlakaualistli
comprometido	tetechtlakautli
prometido	tetechtoli
acusante	teteixpauiani
latido	tetekuikalistli
muros	tetenami
dioses	teteo
santiguado	teteochiuali
piedra	tetl
desengañado	tetlaixtlatilili
desengaño	tetlaixtlatilistli
obediencia	tetlakamatilistli
obediente	tetlakamatini
trazo	tetlamachiualistli
administrador	tetlamamakani
administrativo	tetlamamakili
administración	tetlamamakilistli
exámen	tetlamolistli
examinado	tetlamotili
mozo	tetlanamiuki
prestador	tetlaneutiani
prestado	tetlaneutili
prestamo	tetlaneutilistli
pregunta	tetlanilistli
alcahuete	tetlanochili
doloroso	tetlaokoktli
dispersión	tetlaokolistli
preferido	tetlapalnauili
vistar	tetlapaloa
visitante	tetlapaloani
salutación	tetlapololistli
escandaloso	tetlapololtili
escandalo	tetlapololtilistli
equivocado	tetlapolotili
equivocación	tetlapolotilistli
perdón	tetlapopoluilistli
reconciliado	tetlaseseuili
reconciliación	tetlaseseuilistli
juicio	tetlasontekilistli
juicio	tetlasontekistli
caridad	tetlasotlalistli
palmada	tetlatsinilistli
salpicado	tetlatsinkuinili
consentido	tetlauelkaki
consentimiento	tetlauelkakilistli
desarmado	tetlauitskapitli
repartidor	tetlaxexeluiani
adulterio	tetlaximalistli
respuesta	tetlaxinilistli
adultero	tetlaxinki
servido	tetlayekotili
servicio	tetlayekotilistli
servidor	tetlayekotini
acompañamiento	tetlayelistli
purgatorio	tetlechipaualoyan
acongojado	tetlokoli
continuación	tetokalistli
seguidor	tetokatiutli
continuo	tetokayo
continuamente	tetokayotika
llamado	tetokayotili
llamamiento	tetokayotilistli
cementerio	tetokoyan
molesto	tetolini
molestía	tetolinilistli
alma	tetonali
concierto	tetoskanamiktilistli
piedrecillas	tetoton
instancia	tetototsalistli
esterilizar	tetsaka
esterilizado	tetsakali
esteríl	tetsakatl
esterilizado	tetsakatli
cacaraquear	tetsatsi
castástrofe	tetsauistli
hazaña	tetsauitl
tuberculosis	tetsaukokolistli
aventurero	tetsauyo
aventura	tetsauyotl
retención	tetsikolistli
cascajo	tetsikueuali
retorcido	tetsilmali
retorcer	tetsilmalia
torcer	tetsilua
triquina	tetsiuitl
urano	tetskantsontli
tezontle	tetsontli
mamey	tetsontsapotl
enlazado	tetsonuili
enlazarse	tetsonuilia
enlace	tetsonuilistli
rapado	tetsonximali
freidora	tetsonyokaxitl
nosotros	teuan-
nosotros	teuantin
incorparado	teuantlapoutli
usted	teuantsin
tú	teuatl
rigurosamente	teuelotika
hacia	teuikpa
botella	teuiloapastli
vidrio	teuilotl
alemán	teutontekatl
alemán	teutontlakatl
alemania	teutotitlan
alemán	teutotl
polvoso	teuyo
tejas	texan
auditorio	texankali
difamado	texiktlasali
barbero	teximani
granizar	texiui
granizo	texiuitl
granizada	texiuitli
adolorido	texiutlati
arándano	texokapolin
arándano	texokapolkuauitl
tejolote	texolotl
cirugía	texotlatisilistli
cirujano	texotlatisitl
masa	textli
amasar	texui
regimiento	teyakanalistli
regente	teyakanani
regido	teyakanatli
realeza	teyakankayotl
armas	teyaochiualistli
soldado	teyaotlani
avaricia	teyaouakalistli
tentación	teyeyekoyotl
movimiento	teyoleualistli
movido	teyoleutli
inspiración	teyoliteotilistli
amonestado	teyolmaxilitili
amonestación	teyolmaxilitilistli
consejo	teyolnonotsalistli
inspirado	teyolotili
inspiración	teyolotilistli
demolido	teyouaski
contrario	teyouki
tu	ti-
plaza	tiamikoyan
tendero	tianamakak
tendero	tiankiski
eeuu	tika
acostumbrar	tiknemitia
acostumbrado	tiknemitili
jalado	tilantok
engrosado	tilautli
áspero	tiliktik
apretar	tilinia
modista	tilmachiuki
boutique	tilmakali
telar	tilmaloyan
alfiler	tilmasoani
andrajo	tilmasoli
vestido	tilmauatl
auditorio	timoualkoyan
tinacal	tinkali
ostión	tisikaxitl
medico	tisitl
veterinario	tisiyolkani
medicina	tisiyotl
tititl	tititl
mensajero	titlanekuili
enviar	titlani
embajador	titlantli
augurio	titsauitl
vamos	tiuej
vamos	tiui
lagrimal	tixkuilchili
diarrea	tixtli
valiente	tiyakautli
anegado	tlaaki
blanqueado	tlaauitekki
ver	tlachia
ingenioso	tlachialiani
ventanal	tlachialoyan
adobar	tlachichia
vestuario	tlachichiualoyan
clip	tlachichtli
confirmado	tlachikauali
confirmación	tlachikaualistli
fornido	tlachikautli
raspador	tlachiki
raspado	tlachikili
raspadura	tlachikilistli
funesto	tlachikochiutli
sereno	tlachipauatonali
abatible	tlachitlasaki
acomedido	tlachiuak
conservado	tlachiuali
conservación	tlachiualistli
taller	tlachiualkali
obra	tlachiutli
adivino	tlachixki
taxco	tlachko
visión	tlachkottalistli
barrido	tlachpantitok
barrido	tlachpantli
portería	tlachtiloyan
pelota	tlachtli
previsión	tlachtopaittalistli
ensangrentado	tlaesotili
sufrir	tlaijiyoua
sufrimiento	tlaijiyoualistli
sufrido	tlaijiyouani
padecimiento	tlaijiyouilistli
material	tlailiuischiutli
abreviado	tlailochtili
abreviatura	tlailochtilistli
acierto	tlaipantilistli
acosado	tlaisiuitili
destrucción	tlaispololistli
blanqueado	tlaistali
resfrío	tlaitstililistli
aderezado	tlaixamili
electo	tlaixketsali
conocimiento	tlaixmatilistli
rasguñado	tlaixmomotsoli
rasguño	tlaixmomotsolistli
novio	tlaixnamik
conocimiento	tlaixnematilistli
presente	tlaixpantili
presencia	tlaixpanyotl
embarrada	tlaixpepechilotl
embarrado	tlaixpepecholi
cepillado	tlaixpetlauali
destrozado	tlaixpololi
destrozo	tlaixpololistli
destructor	tlaixpoloni
tumba	tlajkili
mitad	tlajko
tlacotalpan	tlajkotlalpan
ecuador	tlajkotlaltikpan
mediodía	tlajkotonali
mediodía	tlajkotonalpan
parte	tlajkotonyotl
escrito	tlajkuiloli
escritura	tlajkuilolistli
villano	tlajpaliuik
adentro	tlajtek
hablante	tlajto
hablar	tlajtoa
bocina	tlajtoaki
códice	tlajtoamatl
gobernante	tlajtoani
monterrey	tlajtoantepek
consejo	tlajtokalistli
generosidad	tlajtokamekayotl
virrey	tlajtokateixiptlak
reinar	tlajtokati
nación	tlajtokayotl
nobles	tlajtoke
traducido	tlajtokuepalili
poeta	tlajtokuikani
declamación	tlajtokuikayotl
diccionarios	tlajtolamoxtin
diccionario	tlajtolamoxtli
palabra	tlajtoli
embajador	tlajtolikik
contradictorio	tlajtolilochtiani
contradicción	tlajtolilochtilistli
habla	tlajtolistli
embajada	tlajtolkali
traducido	tlajtolkuepantli
letra	tlajtolmachiotl
gramatical	tlajtolmachtiki
alfabeto	tlajtolmelaukan
consejo	tlajtolnamikilistli
vocabulario	tlajtololistli
glosario	tlajtolsentilistli
verso	tlajtolyochitl
humanos	tlakaj
recalcado	tlakakatsali
saturación	tlakakatsalistli
hábil	tlakakini
auditorio	tlakakoayan
accesorio	tlakakoskatl
rendido	tlakalaki
pecho	tlakalakili
encarcelado	tlakaltikautli
antropomorfo	tlakamachiyo
obediencia	tlakamatiyotl
identificación	tlakamatlakuilotontli
obediencia	tlakamatli
gente	tlakamej
parentesco	tlakamekayotl
barbasco	tlakamojeuetl
adelgazar	tlakanaua
adelgazado	tlakanautli
pala	tlakanoni
criollo	tlakapiltik
domar	tlakasiui
domado	tlakasiuki
domador	tlakasiutiani
albino	tlakatastali
diablo	tlakatekolotl
diabólico	tlakatekoloyotl
religiosamente	tlakateoyotika
nacer	tlakati
patria	tlakatian
navidad	tlakatilisiluitl
engendro	tlakatilistli
fecundar	tlakatiltia
hombre	tlakatl
director	tlakatlajtoani
republicano	tlakatlajtokayo
republica	tlakatlajtokayotl
matemático	tlakatlapouayo
avestruz	tlakatototl
caballero	tlakatsintli
amo	tlakauak
olvidado	tlakauali
sobra	tlakaualotl
impedido	tlakaualtili
gigante	tlakaueyak
espacioso	tlakauili
bisonte	tlakaxolotl
libertad	tlakaxoukayotl
liberado	tlakaxoxoutili
antropología	tlakayomatilistli
antropólogo	tlakayomatini
degollado	tlakechtenkili
engañado	tlakeloli
ropa	tlakemitl
taparse	tlakentia
columnata	tlaketsamimili
mordedura	tlaketsomalistli
alquilar	tlakeua
contrato	tlakeuali
contratación	tlakeualistli
contrato	tlakeuayotl
encalado	tlakilili
sacado	tlakixtili
jubilado	tlaknelili
taco	tlako
lanza	tlakochtli
lisiado	tlakokoli
odio	tlakokolistli
revoltura	tlakokoltilistli
escalador	tlakoni
mimbre	tlakoselik
vara	tlakotl
esclavo	tlakotli
encogido	tlakototsoli
banco	tlakoualokoyan
depresión	tlakoyalistli
agujerito	tlakoyokton
tlacoyo	tlakoyotl
roído	tlakuakuatli
enojado	tlakualanili
panera	tlakualchikiuitl
alimentación	tlakuali
restaurante	tlakualkoyan
comido	tlakualo
comedor	tlakualoyan
anfitrión	tlakuanotski
invitado	tlakuanotstli
tlacuache	tlakuatl
tlacuache	tlakuatsin
peine	tlakuauastli
apoyo	tlakuaunapalolistli
tala	tlakuauuitekilistli
cambio	tlakuepalistli
retorno	tlakuepayolistli
cantante	tlakuikak
orquesta	tlakuikalistli
esculpido	tlakuikuitl
escultura	tlakuikuiyotl
pintor	tlakuilo
escribir	tlakuiloa
historial	tlakuiloli
figura	tlakuilomachiotl
pintura	tlakuiloyotl
arrebatado	tlakuitiuetsiani
arrebato	tlakuitiuetsilistli
cuidar	tlakuitlauia
regañado	tlakuitsoli
regaño	tlakuitsolistli
ganso	tlalalakatl
sotano	tlalankali
silo	tlalankueskomatl
terrateniente	tlalej
terratenientes	tlalejke
tierra	tlali
cacahuate	tlalkakauatl
camote	tlalkamojtli
abundante	tlalkiuak
babosa	tlalkonetl
transladar	tlalkuapa
transladado	tlalkuapalili
mapa	tlalmachiotl
topografía	tlalmatilistli
acordarse	tlalnamiki
recuerdo	tlalnamikilistli
pasaporte	tlalnemiamoxtli
remembrar	tlalnemiktia
acometido	tlalnepanualtilistli
chamanismo	tlalnetokayotl
protestante	tlalnetoki
acatólico	tlalnetokini
protestantismo	tlalnetokixtianayotl
protestante	tlalnetokixtiani
protestantísmo	tlalnetokiyotl
bienaventuranza	tlalnokpilualistli
neptuno	tlaloktli
larva	tlalomitl
ocelote	tlaloselotl
país	tlalpan
tlapan	tlalpan
suelo	tlalpantli
soplado	tlalpitstli
conquistador	tlalpoloani
contaminación	tlalpopochtli
sedentarismo	tlalsematilistli
sedentario	tlalsematilo
sorber	tlalteki
terraplen	tlalteli
escombrado	tlaltepeuali
azadón	tlaltepostli
pisón	tlalteuiloni
mundo	tlaltikpak
mundano	tlaltikpakayo
catolicismo	tlaltikpakixtianayotl
católico	tlaltikpakixtiani
tierra	tlaltikpaktli
sembradío	tlaltoktli
cepa	tlaltsontli
archipiélago	tlaluake
lampiño	tlalueltik
tropiezo	tlaluitekilistli
cantárida	tlalxikipili
administrar	tlamachia
maña	tlamachilistli
mañoso	tlamachini
impresora	tlamachiotilamakaxitl
marcado	tlamachiotili
marca	tlamachiotilistli
pesar	tlamachiua
trazo	tlamachiualistli
artesano	tlamachki
alumno	tlamachtili
enseñanza	tlamachtilistli
escuela	tlamachtilkali
escuela	tlamachtilkalko
aprendido	tlamachtilo
alumnos	tlamachtiltin
labor	tlamachtli
manga	tlamaitl
sabio	tlamakatsintli
libertad	tlamakitilistli
conducido	tlamalakayanili
conducción	tlamalakayanilistli
dirigido	tlamalaualili
enderezado	tlamalautli
prensa	tlamalistli
fonda	tlamaluiloni
barrena	tlamamaliuani
descargado	tlamamaltemoui
descargar	tlamamaltemouia
descarga	tlamamaltemouilistli
cargado	tlamamatl
grada	tlamamatlatl
espanto	tlamamauilistli
espantoso	tlamamautini
espantoso	tlamamautli
logro	tlamamitsolistli
sacrificar	tlamana
templo	tlamanakali
sacrificado	tlamanaki
legislatura	tlamanakistli
ofrenda	tlamanali
sacrificio	tlamanalistli
costumbre	tlamanatilistli
crucifición	tlamanayotl
costumbre	tlamanilistli
costumbre	tlamanitilistli
sosiego	tlamantikanilistli
cosa	tlamantli
apretado	tlamapikili
romería	tlamaseualnemilistli
dichoso	tlamaseuani
monaguillo	tlamasteokaltoni
catedrático	tlamatilistemachtiani
catedral	tlamatilisteokali
ciencia	tlamatilistli
sabiduría	tlamatilistli
casino	tlamatilkali
científico	tlamatini
sabio	tlamatini
sabios	tlamatinimej
sabio	tlamatkatsintli
paz	tlamatkayelistli
sabio	tlamatki
partera	tlamatkitisitl
empuje	tlamatopeualistli
admiración	tlamatsauilistli
campeón	tlamauichiuani
maravilloso	tlamauisoli
logrado	tlamauitsoli
engrandecido	tlamauitsotili
engrandecimiento	tlamauitsotilistli
temor	tlamautilistli
ahorcado	tlamekanili
acabar	tlami
matador	tlamiktiani
lisiado	tlamiktili
fin	tlamilistli
otero	tlamimiloli
garrocha	tlamiminaloni
finalista	tlamini
flechador	tlaminki
nublado	tlamixtentok
fertilidad	tlamochiualistli
despegarse	tlamoleui
desprendimiento	tlamoleutli
enjabonado	tlamoluili
desprendido	tlamomoleutli
esparcir	tlamotla
esparcido	tlamotlali
centella	tlamoyotl
embutido	tlanakasali
escuadra	tlanakasanoni
cuadro	tlanakasantli
engordado	tlanakayotili
serenidad	tlanaliuilistli
sereno	tlanaliutimati
tendero	tlanamakak
tienda	tlanamakiskali
acordar	tlanamiki
encajado	tlanamiktili
podado	tlanateki
mensajero	tlanauatili
adelgazamiento	tlanauilistli
silvar	tlanchiki
chiflador	tlanchikini
silvido	tlanchikitli
reducido	tlanechikoli
recogimiento	tlanechikolistli
voluntad	tlanekilistli
contratación	tlanekuilolistli
mezclado	tlaneloli
agitador	tlaneloni
probado	tlaneltilili
firma	tlaneltiloni
libertad	tlanemakayotl
liberación	tlanemaktilistli
libre	tlanemani
curiosidad	tlanematkachiualistli
curioso	tlanematkachiuani
revuelto	tlanemeloli
despejado	tlanemikan
especulativo	tlanemiliani
especulado	tlanemilili
acuerdo	tlanemililistli
especulación	tlanemilistli
deseoso	tlanenekini
comparado	tlanenelili
definido	tlanesemixnauali
definición	tlanesemixnaualistli
amanecer	tlanesi
amanecer	tlaneskayotl
ventana	tlanexilotl
relucido	tlanextili
brillo	tlanextli
pedir	tlania
anafrodisia	tlaniktilistli
odontología	tlankopinalistli
dentista	tlankopinani
conseguido	tlanokpiliuili
disciplinado	tlanonotsali
informador	tlanonotsaliani
información	tlanonotsalistli
contado	tlanonotsalo
informado	tlanonotsatli
dentista	tlanotonaki
odontología	tlanotonakilistli
apresiar	tlanteyotia
apresiado	tlanteyotili
dentista	tlantisitl
triste	tlaokoxki
tristeza	tlaokoyalistli
agusanado	tlaokuili
alhóndiga	tlaosentlatiloyan
empanada	tlaoyotl
pastel	tlaoyotlaxkali
velo	tlapachiukayotl
esconder	tlapachoa
apretado	tlapacholi
paciencia	tlapakkaijyotl
tlapala	tlapalan
mantel	tlapalchiukayotl
ayudante	tlapaleuiani
teñidura	tlapalistli
coloreado	tlapalo
colorear	tlapaloa
saludo	tlapalolistli
pantalla	tlapaloni
colorante	tlapalsoltik
valiente	tlapaltik
firmemente	tlapaltilistika
pintarse	tlapaluia
ventaja	tlapanauilistli
desván	tlapanko
acertado	tlapantili
descubridor	tlapantlasaliani
descubierto	tlapantlasalili
descubrimiento	tlapantlasalistli
compuesto	tlapatili
remedío	tlapatilistli
trueque	tlapatiotl
ensanchamiento	tlapatlaualistli
exprimida	tlapatskitl
abollado	tlapatsoli
abolladura	tlapatsolistli
esfera	tlapayoltik
cuadro	tlapayotl
andamio	tlapechtli
cama	tlapechtli
cerramiento	tlapepecholistli
embravecido	tlapepeualtili
desnudo	tlapetlautli
conquistado	tlapeuali
fantasma	tlapeuiloni
conquistado	tlapeutli
almacén	tlapiakali
guardado	tlapiali
guardián	tlapiani
simular	tlapikia
simulado	tlapikili
forjadura	tlapikilistli
fingido	tlapiktli
defecto	tlapilchiualistli
torre	tlapilkoyan
arete	tlapiloli
aumentar	tlapiluia
trompeta	tlapitsalkuakuauitl
soplón	tlapitsani
globo	tlapitsaxikipili
policía	tlapixki
germinado	tlapixoli
germinación	tlapixolistli
trío	tlapiyekuikalistli
número	tlapoali
numeración	tlapoalistli
puntaje	tlapoalmachiotl
calculadora	tlapoaloni
dominó	tlapoapatolistli
sumido	tlapolaktili
conquistador	tlapoloani
destructor	tlapopoloani
destruido	tlapopololi
doblez	tlapostektli
apareamiento	tlapotilistli
número	tlapouali
numeración	tlapoualistli
matemáticas	tlapoualmatilistli
matemático	tlapoualmatini
abertura	tlapouilistli
contaduría	tlapoukayotl
contado	tlapoutli
vaso	tlapoutli
crepúsculo	tlapoyauak
betún	tlasaloloni
enseñar	tlasaloltia
aprender	tlasaloua
derribado	tlasatli
tostado	tlasektli
admitido	tlaselili
recibimiento	tlaselilistli
determinar	tlaselmiluia
determinado	tlaselmiluili
determinación	tlaselmiluilistli
registro	tlasemachtilistli
comerciante	tlasemanki
propuesta	tlasemijtoli
propósito	tlasemijtolistli
heredero	tlasemololo
prospero	tlasempaktiani
orden	tlasempoualistli
adornado	tlasenkauali
disposición	tlasenkaualistli
adorno	tlasenkauatli
sazón	tlasenkauyotl
despojar	tlasenkuilia
despojado	tlasenkuilili
despojo	tlasenkuilistli
renegado	tlasentelchiuani
inventario	tlasentlaliamatl
frescura	tlasesekatl
resfriado	tlaseselili
resfrío	tlaseselilistli
enfriado	tlaseseuili
frescura	tlaseseyalistli
invierno	tlaseseyan
invernal	tlaseseyotl
cubierta	tlaseualuili
apagador	tlaseuiani
extintor	tlaseuiloni
cansado	tlasiauitili
acoso	tlasijiuilistli
solicitado	tlasiuitili
solicitud	tlasiuitilistli
tendido	tlaskutli
agradecido	tlasojkamatili
agradecimiento	tlasojkamatilistli
amor	tlasojtlalistli
amable	tlasojtli
basura	tlasoli
edificio	tlasolili
reuma	tlasolistli
rastrillo	tlasoloni
basurero	tlasolyokan
costurera	tlasomani
ensartado	tlasosotli
sobajado	tlasotlautli
desplegar	tlasoua
desplegado	tlasouali
despliegue	tlasoualistli
puntada	tlatakauitsoli
rosa	tlataleualtik
procurador	tlataluiani
dimensión	tlatamachili
medida	tlatamachilistli
báscula	tlatamachioualoni
diamante	tlatayatl
acusante	tlateixpauiani
acuerdo	tlateixpauili
servicio	tlatekalistli
ordenado	tlatekpanali
concierto	tlatekpanalistli
despreciado	tlatelchiuali
maldición	tlatelchiualistli
buscado	tlatemoali
buscador	tlatemoani
examinado	tlatemolili
busqueda	tlatemolistli
espiración	tlatemonilistli
descendido	tlatemouili
digestión	tlatemouilistli
difamador	tlatenaualoni
promesa	tlateneualistli
consagrado	tlateochiuali
bendición	tlateochiualistli
protestante	tlateokixtiani
pagano	tlateotokani
endurecido	tlatepitsaualuili
enrejado	tlateposchayauali
imprenta	tlateposkuiloli
reloj	tlatepostlamachotiloni
esponjado	tlatesouili
esponja	tlatesouilistli
tupido	tlatetepacholi
espeso	tlatetsauak
queso	tlatetsautli
estorbo	tlatetsikolistli
tostador	tlateuatsani
majadero	tlatexoni
almidón	tlatexotl
esconder	tlatia
ciencia	tlatilismatilistli
científico	tlatilismatini
señor	tlatiuani
riqueza	tlatkilistli
publicación	tlatkinamakilistli
inmueble	tlatkitl
rico	tlatkiuak
arder	tlatla
repartido	tlatlachikouili
quemado	tlatlak
diablos	tlatlakatekolo
franco	tlatlakatl
atraído	tlatlakouiloni
ahorro	tlatlakuittalistli
ahorrador	tlatlakuittani
fabricante	tlatlaliani
establecido	tlatlalili
establecimiento	tlatlalilistli
medidor	tlatlamachioki
enriquecido	tlatlamachtili
quebrado	tlatlapantli
aumentado	tlatlapiluali
clave	tlatlapololistli
llave	tlatlapoloni
tiro	tlatlasalistli
tocer	tlatlasi
escondido	tlatlatili
secreto	tlatlatili
quemadura	tlatlatilistli
escondrijo	tlatlatiloyan
quemada	tlatlatl
ruego	tlatlautilistli
quiebre	tlatlaxamanilistli
acompañante	tlatlayeni
engrandecido	tlatleyotili
engrandecimiento	tlatleyotilistli
tlacoyo	tlatloyotl
mayorazgo	tlatokapilatkitl
rodrigón	tlatokilotl
contradecir	tlatolilochtia
foto	tlatolkuapali
aconsejado	tlatolnamiktli
desenrollado	tlatomatli
desterreado	tlatotokili
desterrado	tlatotoktli
desenvuelto	tlatotomali
desenvuelto	tlatotontli
tinieblas	tlatoualotl
puerta	tlatsakuilotl
impedido	tlatsikoli
campanero	tlatsiliniani
campana	tlatsilinilistli
campana	tlatsilinitepostli
palpar	tlatsinkilia
introducido	tlatsintili
introducción	tlatsintilistli
chillón	tlatsistli
sostenido	tlatsitskili
pereza	tlatsiualistli
perezoso	tlatsiui
ocioso	tlatsiuini
holgazán	tlatsiuki
trastornado	tlatsonikketsatili
trastorno	tlatsonikketsatli
sastre	tlatsonki
sentencia	tlatsonkilistli
jurídico	tlatsontekilili
jurisdicción	tlatsontekilistli
fuero	tlatsontekoyan
sentenciado	tlatsontektli
inflación	tlatsontilistli
cosido	tlatsontli
abundancia	tlatsotlakilistli
música	tlatsotsonalotl
músico	tlatsotsonki
lazado	tlatsouasilpili
asado	tlatsoyoli
asador	tlatsoyoloni
frito	tlatsoyonili
sartén	tlatsoyoniloni
obligado	tlatsoyotili
obligación	tlatsoyotilistli
atento	tlatta
desierto	tlauakapanixtlaluak
borrachera	tlauanilistli
borracho	tlauanki
taza	tlauanoni
curtido	tlauantli
soldado	tlauapauali
soldadura	tlauapauatilistli
rodrigón	tlauapauilotl
fornido	tlauapautli
nervioso	tlauatik
nervioso	tlauatini
nervio	tlauatl
nervioso	tlauayo
diferido	tlauejkatlaxtli
detenido	tlauejkauak
muy	tlauel
bravo	tlauele
loco	tlauelilok
moldad	tlauelilokayotl
prometido	tlauelittali
gusto	tlauelittalistli
rechazado	tlauelkaki
petición	tlauelkaktli
vengarse	tlauelkixtia
venganza	tlauelkixtilistli
enojo	tlauelmikilistli
otoño	tlauetsi
otoñal	tlauetsiyok
amanecer	tlaui
iluminar	tlauia
remedar	tlauika
llevado	tlauikali
tlahuica	tlauikatl
alumbrar	tlauilia
psiquiatra	tlauililokani
esquizofrenia	tlauililokayotl
psiquiatría	tlauililolistli
iluminación	tlauilistli
claro	tlauilo
vela	tlauilokotl
era	tlauiltekoyan
herida	tlauitektli
óxido	tlauitl
marrón	tlautik
oxidado	tlauyo
enladrillado	tlaxamixkalmantli
cubo	tlaxantetektli
distintamente	tlaxexelostika
gotera	tlaxikalistli
puntal	tlaxilotl
engañar	tlaxima
hacha	tlaximaltepostli
entretejido	tlaxipepanoli
desollado	tlaxipeutli
circuncidado	tlaxipinkuatekini
desecho	tlaxitinili
desordenado	tlaxitinilili
desorden	tlaxitinilistli
cobrador	tlaxitoki
cobranza	tlaxitokilistli
escardado	tlaxiutlasoli
tlascalate	tlaxkalatl
panera	tlaxkalchikiuitl
dona	tlaxkalkoltontli
junípero	tlaxkatl
encantado	tlaxochiuili
brasíer	tlaxochtli
gratitud	tlaxokamalkayotl
torniquete	tlaxoktli
cuenca	tlaxomoli
rebanada	tlaxoxotli
criatura	tlayakoxtli
curtido	tlayamali
entibiado	tlayamanili
temple	tlayamanilistli
abrigado	tlayamanixtimani
curtidor	tlayapixkik
espedido	tlayekoli
servidor	tlayekotiloni
podador	tlayektiani
podado	tlayektili
inventado	tlayokoxtli
fábrica	tlayokoyan
ofendido	tlayolitlakolili
confeción	tlayolmelaualistli
paciente	tlayolotepitsuili
paciencia	tlayolotepitsuilistli
pronosticado	tlayolteouili
pronostico	tlayolteouilistli
oscurecer	tlayoua
rodar	tlayoualochtia
rodante	tlayoualochtiani
tinieblas	tlayoualotl
invento	tlayouili
castigo	tlayouilistli
amparado	tlayuali
estufa	tleamanali
cerillo	tleamatl
encendedor	tlechiualoni
qué	tlein
subir	tleko
disentería	tlekoasiuilistli
cuesta	tlekoayan
subirse	tlekouia
subido	tlekouili
reventar	tlekueponi
reventado	tlekueponili
reventón	tlekueponilistli
quemar	tlekuesalotia
flama	tlemauatl
llamarada	tlemiauatl
chispa	tlemoyotl
lumbre	tlenextli
cualquier	tlensaso
tardío	tleotlakuili
cerillo	tlesakatl
quemar	tletia
fuego	tletl
encender	tletlalia
encendido	tletlalili
lumbrera	tleuilotl
tinta	tlili
bibliografía	tlilmachiamoxtli
grafía	tlilmachiotl
punto	tliltetl
nuestro	to-
caracol	tochakatl
conejito	tochkonetl
conejos	tochtin
conejillos	tochtoton
nombre	tokaitl
firmar	tokatlalia
firma	tokatlalistli
adjetivo	tokatlasenkaketl
sembradío	tokatli
firmado	tokayotlilneltili
sembradío	tokilistli
colmillo	tokuatlak
fortaleza	tolchikaualistli
junco	toli
anemia	tolichtli
junco	tolin
toloache	toloatsin
espadaña	tolpatlaktli
academia	toltekali
artista	toltekatl
madroño	tomaiskitl
suelto	tomaloni
oruga	tomaokuili
oruga	tomaokuilin
tomate	tomatl
gordo	tomauak
gordura	tomauakayotl
muslo	tomaxak
músculo	tometstli
adinerado	tominyi
alimento	tonakatotl
anatomía	tonakayolistli
calendario	tonalamatl
reloj	tonalmachiotl
asolearse	tonalmiki
bronceado	tonalmikki
zodoacal	tonalo
calendario	tonalpoualamoxtli
calendario	tonalpouali
asoleado	tonaluili
sol	tonati
sol	tonatiu
occidente	tonatiuikalakian
cirrostrato	tonatiukali
asoleamiento	tonatiulistli
solar	tonatiuyo
escalofrío	tonauik
venus	tonkitl
venus	tonkitli
entonces	tons
cabecera	tontsontlan
tiesto	topalkatl
fantasia	topalnemilistli
juez	topilej
cintura	topitsauayan
bebedor	topokatl
turín	torin
tuza	tosan
velador	tosoani
vigilia	tosolistli
trasero	toteputsko
estomago	totlatlakuayan
escaramuza	totokatl
desterrar	totokki
pluma	totolakatl
gallina	totoli
gallina	totolin
gallinaza	totolkuitlatl
curioso	totolpaltini
gallinero	totoltepankali
gallinas	totoltin
desatado	totomak
aves	totomej
calor	totomilistli
abotonar	totomiliui
totonaco	totonakatl
caliente	totonik
veracruzano	totonikatekatl
cálido	totonki
calentura	totonkilistli
dorado	totopoktli
tutotepec	tototepek
adelantar	tototsa
dorar	totpoa
tubérculo	totstli
tractor	traktori
zacahuil	tsakauili
pirámide	tsakuali
atajar	tsakuilia
lírio	tsakuxochitl
zanate	tsanatl
rapaz	tsantlauelilok
platano	tsapaloli
platanero	tsapalolkuauitl
platano	tsapalotl
zapotal	tsapokuauitlan
pitáhaya	tsaponochtli
sillón	tsatsasikpali
romper	tsatsayania
gritar	tsatsi
sonido	tsatsilistli
pregonado	tsatsini
ayunar	tsaua
fibra	tsayanatl
cepillo	tsekauastli
sacudido	tsetseloli
colador	tsetseloni
detenido	tsikauki
brincar	tsikuini
brinco	tsikuinilistli
cristal	tsilichtetl
murciélago	tsinakantli
rabadilla	tsinchocholi
celulitis	tsinkestamali
peine	tsinkuauastli
rajadura	tsinkueuali
nalga	tsintamali
cimiento	tsintetl
principio	tsintilistli
nalga	tsintli
terremoto	tsintsinkalistli
pinzón	tsintson
pinzón	tsintsontototl
descocer	tsitoma
sollozar	tsitsikuinoa
repicar	tsitsilitsa
diabólico	tsitsimilo
demonios	tsitsimimej
demonio	tsitsimitl
adeherir	tsitsini
sollozo	tsitsisiunolistli
sostener	tsitskia
laurel	tsitsokuauitl
angosto	tsoltik
coser	tsoma
cempasúchil	tsompanxochitl
sombrero	tsonakauili
almohada	tsonikpali
canas	tsonistali
cabellera	tsonkali
terminar	tsonkisa
termino	tsonkisalistli
gripa	tsonpili
gripa	tsonpinilistli
depilación	tsontekistli
cabeza	tsontekomatl
calavera	tsontekotl
pelo	tsontli
cabellos	tsontsontin
cima	tsonyotl
dulce	tsopeli
verruga	tsotsokatl
paraguas	tsotsomajkiajpaleui
golpear	tsotsona
torpe	tsotsonak
sucio	tsoyok
asar	tsoyonia
frito	tsoyonki
túnez	tunisia
tunecino	tunisiatl
turco	turkatl
turquía	turkia
turco	turkitekatl
turkmenistán	turmenistania
turmenistaní	turmenistaniatl
tuza	tusan
tuvalu	tuvalu
u	u
dueño	uakak
dueños	uakake
guacal	uakali
acanalado	uakaltik
vaca	uakaxi
venir	uala
adviento	ualalistli
llegada	ualalistli
salir	ualkistia
porvenir	ualkistli
traer	ualuika
y	uan
tablilla	uapaltontli
transporte	uasnenki
aparato	uastli
zarzamora	uatsaktli
ladrido	uaualolistli
trazar	uauana
oaxaqueño	uaxyakatl
oaxaqueño	uaxyatekatl
guajolota	ueitotolin
pavos	ueixolomej
lejos	uejka
distante	uejkateitstika
cónsul	uejkatitlantli
consulado	uejkatlajtolkali
televisión	uekaixipkaxitl
soberano	uekapak
antigüedad	uekayotl
muy	uel
acudir	uelamati
recurrido	uelamatini
sandía	ueleyatl
rico	uelik
sentido	uelikamatilistli
suavisante	uelikayo
suavidad	uelikayotl
poder	ueliti
capaz	uelitini
poder	uelitiyotl
gustar	uelitta
aparecido	uelittaloni
aceptar	uelkaki
apreciado	uelkamatili
aprecio	uelkamatilistli
apuesto	uelnesi
finado	uelomik
finado	uelomiki
lenguaje	ueltlajtoli
reportero	ueltlakuilo
caer	uetsi
reir	uetska
broma	uetskalistli
risa	uetskayotl
caído	uetski
risueño	uetskistomak
viejo	ueue
envejecido	ueuetili
anciano	ueuetini
tambor	ueuetl
vejez	ueueyotl
suegro	uexiutli
blasfemo	uexkatlajto
blasfemar	uexkatlajtoa
blasfemia	uexkatlajtoli
huejotzinca	uexotsinkatl
grande	uey
enciclopedia	ueyamoxtli
orgía	ueyauilnemilistli
torbellino	ueyejekatl
banca	ueyikpali
crecer	ueyiya
rascacielo	ueykali
trailer	ueykalmimiloli
dinosaurio	ueykuetspalin
contrabajo	ueymekaueuetl
autopista	ueyojtli
lucero	ueysitlali
emperatriz	ueysiuatlajtoani
doctor	ueytemachtiani
patriarca	ueytepachoteopixki
campana	ueyteposkoyoli
acero	ueytepostli
rey	ueytlajtoani
imperio	ueytlajtokayotl
continente	ueytlalpan
universidad	ueytlamachtilkalko
maravillosamente	ueytlamauisoltika
tuba	ueytlapitsalkuakuauitl
rascacielo	ueytlasololi
ugandés	ugandatl
uganda	ugandia
ugandés	ugantekatl
huichol	uichotl
hacia	uik
llevado	uikalo
pena	uikayotl
venir	uikia
deber	uikilia
azadón	uiktli
proceso	uilistlajtoli
palomino	uilokonetl
homosexual	uilontli
homosexualidad	uilonyotl
homoxesual	uilotiani
cielo	uilouayan
aglomerar	uipana
aglomerado	uipani
bici	uisi
cocerse	uisi
bicicleta	uisiketla
vientre	uitetl
flechar	uitoloua
huizache	uitsachin
colibrí	uitsilin
balsamo	uitsiloxitl
colibrí	uitsitsilin
cardo	uitskilitl
aloe	uitsmetl
biznaga	uitsnauatl
barra	uitsoktli
afilado	uitstik
convulsión	uixkayotl
uzbeko	usbekistanekatl
uzbekistán	usbekistania
resina	uxitl
u	v
vaca	vakaxi
valencia	valensia
valenciano	valensianekatl
valenciano	valensiatl
vanuatu	vanuato
vasco	vaxkatekatl
vasco	vaxkatl
venezuela	venesolan
venezolano	venesolatl
venezolano	venesoltekatl
videocasete	videokaxeti
vietnam	vietnamia
vietnamita	vietnamiatl
violín	violi
violín	violin
violinista	violnemini
xi	x
cabaña	xakali
fechar	xakaloa
despercudido	xakualoli
sobajar	xakualtia
duna	xalan
jalapa	xalapan
jalisco	xalixko
jalisciense	xalixkotl
jalisciense	xalixtekatl
arenoso	xalo
jaltomate	xaltomatl
jamaica	xamaika
jamaiquino	xamaikatl
jamaiquino	xamaitekatl
hender	xamania
entablar	xamanilteka
horno	xamixkaltexkaxitl
ladrillera	xamixkoyan
ladrillo	xamixtli
japonés	xapotekatl
japonés	xapotl
estrundo	xaxamakalistli
rompeolas	xaxamakani
crujir	xaxamatsa
cara	xayakatl
careta	xayaktli
división	xeliuilistli
apartado	xelotok
derrocar	xetinia
distribuido	xexelo
dividir	xexeloa
campechano	xikalankatl
cenote	xikalantli
jicara	xikali
jícama	xikamatl
chichón	xikipiliuistli
monedero	xikipiltomin
difamar	xikitsoa
cometa	xikoatl
vela	xikokuitlali
encerar	xikokuitlaltia
candelero	xikokuitlaochiuki
vela	xikokuitlaokotl
cera	xikokuitlatl
calumniar	xiktlasa
deshorar	xikuetsi
barriga	xilantli
jilotepec	xilotepek
astilla	ximali
trasquilador	ximani
bienvenido	ximopanolti
china	xina
semilla	xinachtli
semental	xinachyo
esperma	xinachyotl
semillero	xinaloani
sinaloense	xinaloatl
deshordenar	xinia
jiote	xiotl
desnudar	xipetsa
desnudo	xipetsok
despellejar	xipeua
desollamiento	xipeualistli
circuncisión	xipinkuayotl
jirafa	xirafatl
ruido	xitekuikalistli
derrocar	xitenia
descompuesto	xitik
alisar	xitlatsoa
jitomate	xitomatl
estallido	xittontlali
explosión	xittontlalistli
explotar	xittontlani
estallido	xittontlanili
explosión	xittontlanilistli
cohete	xittontlaxochitl
té	xiuatl
condimento	xiuitl
abacería	xiukaloyan
tinaja	xiukomitl
era	xiumolpiloyan
anuario	xiupouali
cerámica	xiutepalkatl
años	xiutin
mitra	xiuuitsoli
derramar	xiximi
desbaratar	xixinia
desarmar	xixiui
empeine	xixotl
galápago	xochayotl
flamingo	xochiastatl
aroma	xochiauiyalistli
zanahoria	xochikamojtli
poeta	xochikuikani
abrotoñar	xochilia
floricultor	xochimanki
flores	xochimej
salmón	xochimichin
xochimilca	xochimilkatl
lavanda	xochimojpaltik
floreado	xochimoyeuak
sahumerio	xochiokotsotl
rosa	xochipaltik
aromatizante	xochipoktli
hemorroides	xochisiuistli
flor	xochitl
golosina	xochitlakualistli
goloso	xochitlakuani
paraíso	xochitlalpan
enjundioso	xochiyo
enjundia	xochiyotl
fétido	xokiyak
agrio	xokok
mandarina	xokomandarina
viña	xokomekamili
pasa	xokomekatetsoli
uva	xokomekatl
xoconoxtle	xokonochtli
acedarse	xokoya
úiltimo	xokoyok
trébol	xokoyoli
benjamín	xokoyotl
fútbol	xoktapayolistli
tonto	xolopitli
gesto	xoloxayakatl
pie	xomachiotl
pie	xomachiualoni
jumíl	xomili
jumíl	xomilin
rincón	xomoli
xonacatlán	xonakatlan
prevenir	xonexka
sonorense	xonotatl
sonorense	xonotekatl
cuchara	xonpepetl
patada	xopalmachiotl
primavera	xopan
primavera	xopanistli
primaveral	xopanitstempakayotl
primavera	xopanitstempan
verdoso	xopeleuak
jordano	xordanekatl
jordania	xordania
jordano	xordaniatl
níspero	xotexokotl
pie	xotl
crudo	xotli
flaco	xouakki
hernia	xoxali
verdura	xoxochilistli
vergel	xoxochitlan
verde	xoxoktik
verde	xoxoktli
golpe	xoxolistli
shoshón	xoxoni
idiota	xoxotl
golpeado	xoxotok
juan	xuan
julio	xulio
junio	xunio
verano	xupan
veraniego	xupantlakayotl
verano	xupantlan
yi	y
adiestrar	yakana
constipado	yakapotonili
constipación	yakapotonilistli
punta	yakatli
acabar	yakauki
ablandar	yamania
cálido	yamanik
ablandado	yamanili
amable	yamankak
murmullo	yamankakuikatl
suave	yamanki
suave	yamastik
nuevo	yankuik
novedad	yankuiliskayotl
novedad	yankuilistli
mestizo	yankuitl
mestizo	yankuitlakatl
acercar	yanonasi
fortaleza	yaokali
soldado	yaokiski
militar	yaoktlayekoani
alfil	yaokuachpanitki
enemigo	yaotl
guerra	yaoyotl
colorante	yapali
colorante	yapaltik
circulo	yauali
redondez	yaualiukayotl
redondear	yaualoa
circular	yaualtik
vanidad	yaukatlayotl
propiedad	yaukayotl
tres	yei
miércoles	yeiluitl
el	yej-
derecha	yek
perfección	yekaukayotl
costumbre	yekilistli
entender	yekkaki
amabilidad	yeknakayotl
religiosamente	yeknemilistika
religión	yeknemilistli
convidar	yekolti
santificat	yekteneua
podar	yektia
perfecto	yektik
componer	yektlalia
compuesto	yektlalili
santo	yektli
comportarse	yelia
arado	yelimiki
comportamiento	yelistli
naturaleza	yelisyotl
pechuga	yelsisiyotkatl
sustantivo	yeltik
anteayer	yeouilpa
pero	yesej
primo	yesini
vena	yesneluatl
sangre	yestli
pesado	yetik
tercero	yeto
caber	yeui
anteayer	yeuiptla
meteorología	yeyamatilistli
meteorólogo	yeyamatini
lugar	yeyantli
buenos	yeyektin
satisfecho	yeyolmaxilili
noche	yoali
paz	yokoxkayotl
reposado	yokuxkayo
esfuezo	yolchikaualistli
vivir	yolia
despacio	yolik
espiritual	yoliliso
dialogo	yolilistlajtoli
ánima	yolilistli
filosofía	yolismatilistli
prudente	yolismatini
prudencia	yolismatkayotl
astuto	yolismatki
vida	yolistli
acémila	yolitl
jubilado	yolitlamanemi
conciencia	yolixtli
mascota	yolkaikniutli
animales	yolkamej
animalejo	yolkapoli
animal	yolkatl
animalillo	yolkatontli
insecto	yolkatsin
animalito	yolkatsintli
desmayar	yolmiki
desvanecido	yolmikilili
desvanecimiento	yolmikilistli
aprobar	yolnankilia
aprobado	yolnankilili
aprobación	yolnanqulistli
estetoscopio	yolokakiloni
descuidado	yolokimali
descuidar	yolokimatia
descuido	yolokimatilistli
iracundo	yolokokolkuik
inconstancia	yolokuekuepkayotl
prudencia	yolomachilistli
prudente	yolomatki
locura	yolopoliukayotl
ecologista	yolosemanauatini
ecología	yolosemanauayotl
generoso	yolotlapaltik
corazón	yolotli
corazoncito	yolotsin
corazoncito	yolotsintli
melocotonero	yoloxokuauitl
corazonada	yoloyotl
contento	yolpachiui
alegrar	yolpaki
mansedumbre	yolseukayotl
despacio	yoltik
rondar	youalapia
noche	youali
anal	youikuik
modestia	youinemilistli
modesto	youinemini
sabandija	yoyoli
corazones	yoyolo
prenda	yoyomitl
sinagoga	yudiokali
judería	yudionesentlalistli
sinagoga	yudioteokali
judío	yudiotl
judío	yudiotlakatl
judaísmo	yudioyotl
yucatán	yukatan
intento	yukateyolistli
intención	yukateyolisyotl
intencional	yukateyoloni
tal	yuki
así	yukin
utah	yutan
yutano	yutatl
yute	yutli
¡espera!	¡chia!
¡calma!	¡kauik!
¡asomate!	¡nanaj!
¡felicidades!	¡pakiliskayoli!
¡alto!	¡uejkapa!
¿cúal?	¿kajtli?