nah	esp
-ko	lugar
-lan	lugar
-pan	sobre
-tepiton	chico
-titlan	entre
-tontli	chico
-tsin	-ito
-tsintli	pequeño
-tsitsin	demaciados
-uakan	lugar
a-	no
a	a
aakki	furioso
aasini	conocedor
aauatlan	selva
aauiani	alegre
aauilpan	parque
abrili	abril
achalchiuitl	mármol
acheli	pepita
achi	algo
achiapopotl	gasolina
achiauitl	charco
achichikatlauini	mandón
achichinki	chupadero
achichintli	guardaespaldas
achichipiktli	estalagmita
achik	breve
achikauak	frágil
achikauali	debilitado
achikaualistli	flojera
achikauayotl	debilidad
achikuali	razonable
achinamilpan	chinampa
achineneuki	parecido
achiotl	achiote
achipotsauak	inflado
achitonkalistli	momento
achitotontsin	átomo
achitsin	poquito
achitsinko	poco
achiualoki	prohibido
achiualoni	prohibido
achiyamaschiuki	molino
achiyamastik	molido
achka	cerca
achkaitl	pronombre
achkali	granero
achkautli	capitán
achsijtli	bisabuela
achtli	grano
achto	antes
achtontekaj	comandantes
achtontekali	comandancia
achtontekatl	comandante
achtontli	bisabuelo
achtopa	primero
achtopan	anterior
achtotipan	antes
achtotlakatl	primitivo
aejekatl	marea
afgania	afganistán
agoxto	agosto
aguaskaltekatl	hidrocálido
aik	nunca
aikmikini	inmortal
aikmikistli	inmortalidad
aikni	padecer
aiknilistli	padecimiento
ainilistli	acto
aitia	ejecutar
aititl	abedul
aituali	patio
aitualkali	kiosco
aitualoyan	portón
aiuteittalistli	alcance
ajachtli	sirviente
ajauia	regocijar
ak	alguien
aka	alguno
akachatl	langostino
akaj	alguien
akakauastli	grama
akalachiani	marinero
akalan	acalán
akalanelotl	grumete
akalasali	embarcado
akalayayalistli	sentina
akali	barco
akalko	embarcadero
akalkochiuayan	camarote
akaloa	acanalar
akalokuauitl	pinabete
akalotl	estanque
akalpantilistli	vela
akalpatlani	avión
akalpatlanitontli	avioneta
akalpechtli	canoa
akalpoli	buque
akalteichtekamiktini	pirata
akaltekoyan	puerto
akaltetlalinkatekoni	lastre
akaltik	acanalado
akaltikanemini	navegante
akaltikaneminilistli	navegación
akaltikapanoni	grumete
akaltontli	canoa
akalueltekani	timonel
akamapichtli	boquilla
akamapili	puntero
akamati	desembocar
akamatl	desembocadura
akamayatl	acamaya
akanixmauki	atrevido
akanoyeui	faltante
akantetlaneui	semejante
akapatli	laurel
akapolkatl	acapulqueño
akatkani	exitado
akatlan	cañaveral
akatlapitsali	zampoña
akatsakuistli	pegamento
akattopa	inicialmente
akauali	gigantón
akaualko	baldío
akauatl	maleza
akaxitl	alberca
akaxotlan	balneario
akaxtontli	pilar
akayak	nadie
akayetl	pipa
akayokan	acayucan
akentenchiuayotl	inocencia
akentlattalistli	travesura
akentlattani	travieso
akimamatkayotl	necedad
akin	quién
akisalistli	natación
akisani	nadador
akochilistli	velatorio
akocholoa	faltar
akokali	mansión
akokitsa	progresar
akokitsalistli	progreso
akokitskili	alzado
akokoko	lirio
akokui	levantar
akolmaitl	antebrazo
akolmaitl	brazo
akomana	alborotar
akomanalistli	alboroto
akomanani	alborotador
akomitl	tinaja
akopa	arriba
akopan	sobre
akopechtli	mesa
akordioni	acordeón
akosili	acocil
akosilin	acocil
akostik	crema
akotlasalistli	consolación
akouetsi	confortar
akouetsiki	confortable
akouetsilistli	aliento
akoueuetilistli	contemplación
akoui	alzar
akouili	despegado
akoyalistli	contemplación
akoyani	contemplativo
akoyoktli	drenaje
aktitlasatilistli	hundimiento
akuali	mal
akualitilistli	maldición
akualotl	malicia
akualtlajtoli	grosería
akuanuastli	elevador
akuatsin	ruda
akuayolo	ignorante
akuekueyachin	sanguijuela
akueskomatl	acantilado
akueyotl	ola
akxoyaokotl	araucaria
alachin	flema
alaktik	resbaloso
alaskak	alaska
alastekatl	alaskeño
alaua	resbalar
alauak	resbaladizo
alauakatl	junto
alaxtik	liso
albanekatl	albanés
albania	albania
albaniatl	albanés
aleluya	aleluya
algeria	argelia
algerianekatl	argelino
algeriatl	argelino
alomej	papagayos
aloyotl	escroto
altepemaitl	villa
altepemej	ciudades
altepemili	terreno
altepemilpan	parcela
altepeojtli	avenida
altepepaleuini	procurador
altepesiuatlajtoani	alcaldesa
altepetenankoyoktli	almena
altepetl	ciudad
altepetlajtoani	alcalde
altepetlajtokayotl	municipio
altepetlakak	paisano
altepetlakatl	ciudadano
altepetlakayotl	civilización
altepetlalia	poblar
altepetlaniani	urbanista
altepetlatilantok	distrito
altepetlatilantoke	distritos
altepetlatskoni	confederado
altepetusan	rata
altepeyotl	urbanidad
alteptlatilantok	distrito
alteptlatskostli	confederación
altia	bañar
altik	bañado
altikali	baño
altikaltin	baños
amachiotl	boya
amaitl	estero
amakapolin	mora
amakostitototl	tildío
amakuauitl	amate
amakuiloni	cartero
amamachioni	escritor
amamachiotl	libreta
amamalokotl	taladro
amamej	papeles
amamekatl	discurso
amana	distraerse
amanali	presa
amanamakoyan	papelería
amanatli	charco
amantekatl	artesano
amantekayotl	tecnología
amantoli	artesanal
amaometlakuiloli	plano
amapatoli	naipe
amapotl	ababol
amatki	ignorante
amatkiyotl	analfabetizmo
amatl	papel
amatlakuilistli	correo
amatlakuilo	escribano
amatlakuilokan	secretaría
amatlakuilolanetilistli	epístola
amatlakuiloli	carta
amatlakuilolmachioli	remitente
amatlakuiloloyan	correo
amatlakuilopoalkali	graficador
amatlakuilotontli	ficha
amatlakuilotsakuani	cartero
amatlatsontli	carpeta
amatojtli	mapa
amatomin	billete
amatsin	documento
amatsoma	encuadernar
amatsomalili	encuadernado
amaxak	delta
amaxokotl	zarzamora
amayakatl	antifaz
amej-	vos
amekatl	manguera
ameli	pozo
amen	amén
ameuan-	ustedes
ameuantin	ustedes
ameuatik	pesado
ameuatl	usted
ameyali	fuente
ami	cazar
amikilistli	inmoralidad
amikini	inmortal
amikistli	sed
amikkatl	ahogado
amiktlan	laguna
amilistli	cacería
amilkilisyotl	inmortalidad
amilkini	inmortal
amimatik	tosco
amimitl	dardo
amini	cazador
amitla	nada
amiximatini	millonario
amixmachtli	desconocido
amixmachuastli	ovni
amixmati	confundir
amixmatili	confundido
amixmatilistli	confusión
amo-	vuestro
amo	no
amoixnauamikilistli	irresistible
amoixnauatia	abolir
amoixnauatilistli	abolición
amoixnauatini	abolidor
amoixpani	ausente
amoixtlapaltik	miope
amoketsak	impúdico
amokinkantin	antiguamente
amoknelilmatini	desagradecido
amokotontlani	necio
amokuali	malo
amokualnesi	feo
amolayotl	shampoo
amoli	jabón
amolistli	negación
amolkaxitl	jabonera
amomikmana	negar
amomotlaliani	andariego
amomotokilismak	inquilino
amonamiki	diferir
amonamiktli	discrepancia
amonauatilmak	imprudente
amonauatilmatini	odioso
amoneltika	dudosamente
amoneneukayotl	diferencia
amoneneuki	diferenciar
amoneuki	diferente
amonimanauati	callar
amoninokaki	inconforme
amono	tampoco
amonotsalani	deprimido
amopatik	barato
amopiluani	verdugo
amosan	sino
amosaneli	osado
amosaneltsoyani	caritativo
amosaneltsoyotl	caridad
amosankenani	virtuoso
amosayotl	paradigma
amoteoni	ateo
amotlaixtilili	despreciado
amotlakpak	bajo
amotlakuauak	ostinado
amotlamini	infinito
amotlapaltik	cobarde
amotlapaltik	incoloro
amotlasotli	gratis
amotlatini	desatento
amotlattilistli	desatención
amotlaueli	manso
amotlein	nada
amouan	vuestro
amoueli	imposible
amoxatli	librería
amoxexelistli	capítulo
amoxikuilo	literato
amoxiutlatiani	bibliotecario
amoxkali	librero
amoxmatki	alfabeta
amoxpouani	lector
amoxtentli	margen
amoxtin	libros
amoxtlajtoalpeualistli	prólogo
amoxtlajtoli	glosario
amoxtlajtoltsintli	índice
amoxtlajtoyotl	literatura
amoxtlatiloyan	biblioteca
amoxtli	libro
amoxtlikoyan	librería
ana	tomar
anak	marginado
anakmosatlani	aislado
anali	allende
analko	allende
andaloxtekatl	gitano
anej	adios
anekilistli	superfluo
anekiloyotl	vanidad
anekotona	escasear
anekotonalistli	escasez
anematilistli	necesidad
anemokaknekili	disimulado
anemokkakneki	disimular
anemokkanekilistli	disimulo
anemokkanekini	disimulador
anepalko	bahía
anetlakualtilili	depravado
anetlakualtilistli	depravación
aneuan-	ellos
aneuantin	ellos
aneuatsi	útil
anglitekatl	inglés
anglitl	inglés
anglitlalpan	inglaterra
anglitlaltekatl	anglicano
anilitia	traer
aninokotontlani	tacaño
aninomamati	descarar
aninomamatini	descarado
aniuaya	transportar
ankimo	diariamente
ansterdania	ámsterdam
anxeli	ángel
anxelin	ángel
aokaya	apenas
aokichyolo	miedoso
aokkichyolo	miedoso
aoktli	pulque
aokueli	insoportable
aompaneuak	pendejo
aompaneualistli	pendejada
aompaneui	desgraciado
aompayotl	desgracia
aontenekini	inconveniente
aotlakanamiyotl	ociosidad
aoui	seguro
apachakatl	arroyo
apachioualistli	diluvio
apachtli	apache
apancholoa	saltar
apancholoani	saltador
apancholoanilistli	salto
apankayotl	marino
apantlakuiuayan	dique
apantli	acequia
apapachoa	apapachar
apastetl	cazuela
apastlapaloni	tina
apastli	coladera
apatiuki	barato
apichauki	entelerido
apinaua	desvergonzar
apinauali	desvergonzado
apinaualistli	vergüenza
apipiloluastli	mosquete
apipiyalotl	libélula
apismiki	inanición
apitsali	cámara
apitsatli	diarrea
apitsmikini	hambriento
apitsmikistli	hambruna
apitsolistli	gula
apojtli	vapor
apolanko	wc
apolankoyan	wc
apopokatl	geiser
aposonali	ámbar
apotsonakilotl	espuma
apotsonali	nata
apotsontli	espuma
apoxkauki	enlamar
apoxtoli	apóstol
aragonekatl	aragonés
aragoni	aragonés
aragonia	aragón
aroba	aruba
arrankado	tlaquixtilli
asauyatl	asenso
asej	quizá
aselana	espulgar
aseli	liendre
aselin	liendre
aseloni	liendroso
asemeli	desagradable
aserbaiyanekatl	azerbaiyano
aserbaiyatl	azerbaijano
aserbayania	azerbaiyán
asesekpan	iceberg
asesexokotl	frutilla
asetl	aguanieve
asikamati	comprender
asikamatili	comprendido
asiki	localizado
asiki	localizar
asitiuetsi	arrebatar
asitl	alcance
asitlali	aljófar
asitlalin	aljófar
asiuamichtli	sirena
askamoli	escamoles
askapotsali	hormiguero
askaxali	hormiguero
aski	casi
asmej	alas
aso	probablemente
asomali	calma
asomaluauetl	experiencia
astapiltik	blancura
astektli	aspa
astitok	alado
astli	ala
atak	ausente
ateixkoa	atreverse
ateixkotlachialistli	atrevimiento
ateixkotlachiani	atrevido
atekakini	desobediente
atekauki	molesto
atekaxmatemaloyan	alberca
atekochtlali	aljibe
atekochtlaltin	aljibes
atekochtli	jaguëy
atekochtsakuali	presa
atemalistli	hidropesía
atemi	empiojar
atemoktli	cascada
atemostli	cascada
atemouia	enfrentar
atempachtli	piojoso
atenamachpan	súbitamente
atenamitl	tejado
atenia	atenas
ateskatl	lago
atetechasini	bravo
atetlakamatilistli	desobediencia
atetlakamatini	desobediente
atexakatl	almeja
atia	derretirse
atik	esfumado
atilia	derretir
atipochoa	rellenar
atiuatsolistli	metáfora
atiuitsoa	encomendar
atiuitsouilistli	encomienda
atla	mollera
atlachaneki	marisco
atlajtoalamini	parlanchín
atlakaki	incorregible
atlakamachtili	bruto
atlakanemilistli	travesura
atlakanemini	travieso
atlakaneminilistli	disolución
atlakanesi	cruel
atlakasemeli	revoltoso
atlakasoyotl	gratis
atlakatlajtoak	descortés
atlakatlajtolistli	descortesía
atlakayotika	inhumanamente
atlakayotl	crueldad
atlakomoli	barranca
atlakuisiuatl	ninfa
atlalili	aljibe
atlalistli	hidrosfera
atlamati	presunto
atlamatilistli	presunción
atlamiki	ahogar
atlamikini	ahogado
atlanetlaminalistli	canotaje
atlaneyolo	puro
atlanteittani	gotero
atlantekatl	atlante
atlantiko	atlantida
atlapali	ala
atlasa	agonizar
atlasotli	vil
atlatl	lanzadardos
atlatlamachtili	perseguido
atlaua	ahogarse
atlauinani	aburrido
atlautli	cañón
atlauxomoli	quebrada
atle	nada
atleinakkak	inservible
atleinemik	solitario
atlekikaualistli	avaricia
atlekixkauak	codicioso
atlelitia	rebajar
atlelitilistli	rebaja
atletilistli	suicidio
atletl	aguardiente
atleueli	desdichado
atleuelitik	indiscreto
atleyeni	haragán
atlini	bebedor
atliuani	vaso
atolchiuki	atolero
atoli	atole
atomiyo	pelón
atonauilistli	fiebre
atonauki	asoleado
atototl	gaviota
atoyamichin	trucha
atoyatentli	rivera
atoyatl	río
atoyatontli	riachuelo
atsakuali	compuerta
atsakuali	presa
atsapotl	pera
atskaualo	estanque
atsontsontli	pilote
au	y
aua	reñir
auachia	rociar
auachtli	rocío
auakamoli	guacamole
auakatin	aguacates
auakatli	aguacate
auakoyan	acuario
aualistli	perfume
auatomatl	bellota
auatsalistli	agotamiento
auatsi	agotar
auauatl	carrasco
auautli	aguautle
auaxokotl	drupa
auelatoani	amordazado
auelnemilistli	refinería
aueuetl	ahuehuete
aueyak	nivel
auiak	fragante
auiakatl	desodorante
auiakpopotli	canela
auialia	perfumar
auiankali	burdel
auikyani	turista
auikyanilistli	turismo
auikyauki	vagabundo
auikyayoa	turistear
auikyayoani	turista
auikyayotl	turismo
auilatoani	presumido
auilistli	alegría
auilkixtiani	prodigo
auilnelistli	sexo
auilnemi	fornicar
auilnemiki	lujurioso
auilnemini	vicioso
auilneminilistli	vicio
auilneyo	sexual
auilneyotl	sexualidad
auiltepolia	masturbar
auiltepolistli	masturbación
auiltikayok	deportivo
auiltikayotl	deporte
auiltsonkuitlamej	juguetones
auiltsonkuitlatl	juguetón
auineminilistli	lujuria
auitili	desodorante
auitsonxoloni	juguete
auiyak	aromatico
auiyo	aromático
auyani	teibolera
auyankali	burdel
axachtli	aluvión
axan	ahora
axeloli	delta
axia	asia
axiatekatl	asiático
axiatl	asiático
axiltili	apuntado
axin	maquillaje
axitia	acercar
axitialistli	acercamiento
axiuayan	hotel
axiuayani	hotelero
axixkali	sanitario
axixpan	muladar
axixtli	orina
axkaitl	posesión
axkampa	luego
axkan	hoy
axkanilistli	presente
axkanistika	actualmente
axkantika	actualmente
axkatia	adueñar
axkatiani	dueño
axkatianimej	dueños
axkatl	hacienda
axkauia	abundar
axkauilistli	abundancia
axkayotl	dominio
axnosiuatl	burra
axnotl	burro
axnotsatsi	rebuznar
axnotsatsilistli	rebuznido
axolokuetspalin	salamandra
axolomichin	bagre
axolotl	ajolote
axomoli	estuario
axturia	asturias
axturiatekatl	asturiano
axturiatl	asturiano
ayak	nadie
ayakachtli	sonaja
ayakuael	temprano
ayamiktlan	norte
ayamiktlani	norteño
ayamotlakxotili	crudo
ayatlekikuak	ayuno
ayaxkanyotika	lentamente
ayayanoa	desquebrajar
ayekilua	pensar
ayekimatilistli	pensamiento
ayekimatini	pensador
ayemo	todavía
ayeutiuetsi	agachar
ayi	hacer
ayok	cambiado
ayokakatsintli	desaparición
ayokalotl	caparazón
ayolomatki	imprudente
ayoluastli	pozo
ayonekutli	aguamiel
ayotli	calabaza
ayotochtin	armadillos
ayotochtli	armadillo
ayoualtlaltin	archipiélago
ayoui	fácil
ayouika	facilitar
ayouika	fácilmente
ayouilistli	facilidad
ayouitika	fácilmente
ayoyo	jugoso
ayukayotl	desacierto
b	bi
bajamaj	bahamas
barbadiaj	barbados
barselona	barcelona
belarruxia	belarus
belxika	belgica
belxikatl	belga
belxitekatl	belga
bermudiaj	bermudas
botsuantekatl	botswano
brasilia	brasil
brasiliatl	brasileño
brasiltekatl	brasileño
bruxelia	bruselas
budateotl	buda
burmia	birmania
burmianekatl	birmano
burmiatl	birmano
burundia	burundi
butanekatl	butanés
butania	bután
butaniatl	butanés
ch	chi
chachaiakistli	vocerío
chachajalakatototl	chachalaca
chachakuak	áspero
chachalakani	hablador
chachalakatl	chachalaca
chachalakatototl	chachalaca
chachalaktia	destartalar
chachalaktik	destartalado
chachalaktli	destartalador
chachalani	murmurador
chachamaua	jactarse
chachamautli	jactado
chadia	chad
chakali	camarón
chakaliui	agusanarse
chakayoli	calloso
chakmoli	gladiatorio
chalani	destemplado
chalchiuitl	esmeralda
chalchiukali	joyería
chalchiukomolan	chalchicomula
chalchiuximatki	joyero
chalkani	ciénaga
chalkatl	chalca
chalko	xalco
chamako	chamaco
chamaokosok	chamagoso
chamaua	engordar
chamauak	crecido
chancho	desaliñado
chanej	casero
chanek	salvaje
chaneki	cheneque
chankali	departamento
chanti	vivir
chantia	vivir
chantin	casas
chantlakauan	familia
chantlalkali	granja
chantlayokan	condominio
chantli	casa
chapani	desprender
chapankini	empapado
chapoli	saltamontes
chapolin	chapulín
chauakatl	chabacano
chauakuauitl	albaricoque
chauastin	celos
chauatilia	celar
chauatl	celoso
chauauani	chihuahuense
chauitstli	plaga
chayotli	chayote
chialia	ingeniar
chiankaka	azucarar
chiankakatetl	mazapán
chiankakatl	azúcar
chiankakayo	azucarado
chiantletl	diesel
chiapanekatl	chiapaneco
chiapatl	chiapaneco
chiapopojtli	carretera
chiapopotl	chapopote
chiapopotlani	petrolero
chiatl	chía
chiauik	grasoso
chiauikayotl	aceite
chiauisotl	grasa
chiauitl	oruga
chiauitli	aceite
chichani	escupidor
chichetl	alhaja
chichi	perro
chichik	amargo
chichikatl	hiel
chichikaui	mancha
chichiki	descarado
chichikitsatsilistli	grito
chichikok	disparejo
chichikoli	bisabuelo
chichiktik	amargoso
chichikuilotl	chichicuilote
chichilamatl	bisabuela
chichiliuili	enrojecido
chichiltik	rojo
chichiltototl	petirrojo
chichimej	perros
chichimekaj	chichimecas
chichimekatl	chichimeca
chichinakatl	dolor
chichinaktik	doloroso
chichinatsali	afligido
chichini	mamador
chichinik	mamado
chichininpoli	mamón
chichinki	chupador
chichinoa	quemar
chichinoli	quemado
chichinolistli	incendio
chichipaltik	bello
chichipina	destilar
chichipinili	destilado
chichipinilistli	destilación
chichiti	amamantar
chichitili	amamantado
chichitlauelilo	rabioso
chichitlauelilokayotl	rabia
chichitli	mancha
chichiuali	seno
chichiuauake	ladrerío
chichiuayoli	mamila
chichiuia	arremedar
chichiuili	arremedado
chichiuilistli	arremedo
chichiyotl	perruno
chikalotl	abrojo
chikauak	duro
chikaualistli	fortaleza
chikaukayotl	dureza
chikautilistli	fuerza
chikautok	fuerte
chikimolin	ruiseñor
chikitl	chico
chikiton	chiquito
chikitsin	chiquitín
chikiuitl	canasta
chikiutapayolistli	básquetbol
chiknaumiktlan	inframundo
chiknautopan	cielo
chiko	junto
chikome	siete
chikomeiluitl	domingo
chikotlamanilistli	sospecha
chikotlamatini	celoso
chikoyoloa	sospechar
chikoyoloani	sospechoso
chikoyotl	sospecha
chiktli	chicle
chikuakoli	callado
chikuase	seis
chikuaseiluitl	sábado
chilakatl	chilaca
chilakili	chilaquil
chilakilitl	chilaquil
chilantekatl	chileno
chilatl	chilate
chilatoli	chile-atole
chili	chile
chilkamojtli	rábano
chilkaxitl	salsera
chilmamoli	salsa
chilmoli	chilmole
chiltik	rojo
chiltototl	calandria
chilxiuitl	especia
chimali	escudo
chimalkaltia	escudarse
chimalki	escudero
chimiskoli	chisme
chimiskouia	chismorrear
chimiskouik	chismoso
chinamilpan	chinampa
chinamitl	cerco
chinkatl	deshorden
chinkua	chingar
chinkualaktli	chingadera
chinkuali	jodido
chinkualnematini	alergico
chinkualsauatl	urticaria
chipakkaltik	reluciente
chipauakanelistli	castidad
chipauayotl	pureza
chipeliueskixtia	herir
chipeliui	herida
chiprianekatl	chipriota
chipriatl	chipriota
chisiuinakilistli	dolor
chitik	chicloso
chiualistli	forma
chiualtlakatl	culto
chiualtlakayotl	cultura
chiuatlajtoli	verbo
chiuaualistli	ladrido
chiuauani	chihuahuense
chiuauatekatl	chihuahuense
chiuauatl	chihuahuense
chokakilistli	llanto
chokalistli	llanto
chokiktli	bramido
chokilistli	llanto
chokistli	chillido
choloa	huir
chololi	corrido
cholololi	despeñado
chololtekatl	cholulteca
chontali	extranjero
chontalmamatilistli	xenofobia
chontalmamatli	xenofóbico
chukan	teatro
d	di
dania	dinamarca
daniatekatl	danés
daniatl	danés
dekaxitl	dedal
disiembri	diciembre
dixketl	diskette
domingo	domingo
dominika	dominca
dominikatl	dominicano
dominitekatl	dominicano
e	e
ejekaixnamikilistli	contraviento
ejekakiauitl	tempestad
ejekakoamixtli	tromba
ejekalistli	atmósfera
ejekalkixoayan	aeropuerto
ejekamalakatl	remolino
ejekamej	aires
ejekanamiktilistli	huracán
ejekatemoani	paracaidista
ejekatl	viento
ejekatlapalki	aérodeslizador
ejekatsakauiloni	aventador
ejekatsakuili	rompeviento
ejemi	apolillarse
ekakoyoktli	gárgola
ekatl	soya
ekatsakuili	anorak
ekauastik	escala
ekauastilistli	proporción
ekauyo	protector
ektli	concha
ekyolotli	nácar
elchichinatl	agruras
eleki	convencer
elekia	convencerse
elekili	convencido
elekiltin	convencidos
elekitl	convencimiento
eleli	pena
elepanomitl	marfil
eleuia	desear
eli	hígado
eliutili	deseoso
eliutilistli	deseo
eliutistik	deseoso
elkokolistli	hepatitis
elkomali	espalda
elotl	elote
eloxochitl	magnolia
elpanchichiko	calvario
elpantli	pecho
elsisiui	suspirar
elsisiuilistli	suspiro
eltapachtli	hígado
eltsatsaki	tartamudo
eltsatsakini	tartamudo
eltsatsakui	tartamudear
eltsotsoli	papada
eluayotl	alma
emej	frijoles
enero	enero
epyolopisili	aljófar
esisiutli	carnal
eskoktli	vena
eslovakia	eslovaquia
eslovenekatl	esloveno
eslovenia	eslovenia
esloveniatl	esloveno
esnakakuitlaxkotli	morcilla
eso	sangrar
esoli	sangrado
esolistli	sangría
esoloni	sangradera
esoltesoni	sangrador
esoni	sangriento
estekpatl	ágata
estlatlaxtini	tuberculoso
estli	sangre
estokolmo	estocolmo
estonekatl	estonio
estonia	estonia
estoniatl	estonio
esxokokuauitl	granado
esxokotl	granada
etik	pesado
etl	fríjol
etlan	frijolar
etontli	habichuela
etsona	agitar
etsonki	agitador
etsontilistli	agitación
etsontli	agitado
eua	partir
euamatl	pergamino
euamekatl	correa
euanelpiloli	cinturón
euapetlakali	maleta
euapitskali	talabartería
euatl	cuero
euatlamamali	cazadora
euatlapitsalnemini	gaitero
euaueuetl	pandero
euaxikipili	alforja
euayotlastli	escamado
euro	euro
exotl	chícharo
exotontli	habichuela
eyopan	anteantier
f	fi
febrero	febrero
filandia	finlandia
filantekatl	finlandés
filatl	finlandés
g	gi
gabonekatl	gabonés
gaboniatl	gabonés
galitekatl	francés
galitl	francés
galixiatl	gallego
galixitekatl	gallego
gania	ghana
gelagetsa	guelaquetza
gelatinatl	gelatina
granadatl	granadino
granadia	granada
granatekatl	granadino
ichantletl	infierno
ichkakonetilmali	mameluco
ichkakonetl	cordero
ichkamej	ovejas
ichkanemastli	playera
ichkapia	pastorear
ichkapixkayotl	pastoril
ichkapixki	pastor
ichkasoli	estopa
ichkatlamamali	chamarra
ichkatlapopoloak	borra
ichkatsomitl	lana
ichpochsiuatl	dama
ichpochtin	doncellas
ichpochtli	donsella
ichpochyotl	virginidad
ichpokakonetl	damita
ichpotikayotl	vaporoso
ichtakayo	confidencial
ichtakayotl	secreto
ichteki	robar
ichtekke	ladrones
ichtekki	ladrón
ichtlakatlajtopiani	secretario
ijitlakolistli	análisis
ijiyotia	respirar
ijiyouia	soportar
ijiyouili	soportado
ijiyouilistli	soporte
ijkin	así
ijkon	así
ijkuaili	aportado
ijkuailia	aportar
ijkuak	cuando
ijkuiloa	escribir
ijkuilotik	escrito
ijtlako	descompuesto
ijtlakoa	descomponer
ijtoa	decir
ijyotl	aliento
ik	por
ika	con
ikakakistli	consonante
ikalakian	occidente
ikalakiani	occidental
ikalakini	occidental
ikalia	pelear
ikampa	atrás
ikan	como
ikatok	erecto
ikimej	bastantes
ikisayan	oriente
ikisayo	oriental
ikitilistli	tejido
ikitiualoyan	telar
ikitiuatli	tela
iknelia	ayudar
iknelilistli	atuda
ikneliyotl	caridad
iknitl	hermano
ikniupili	amiguito
ikniupipil	amiguitos
ikniutiloni	amigable
ikniutli	amigo
ikniuyaoyotl	revolución
ikniuyo	amistoso
iknoakayotl	piedad
iknoli	miserable
iknomati	comprender
iknomatilistli	comprensión
iknomatki	comprensivo
iknopiluia	mendigar
iknotl	pobre
iknotlakamej	pobres
iknotlakatl	mendigo
iknotlakayotl	indigencia
iknouak	desamparado
iknouatl	desamparo
iknoyotl	miseria
ikotoka	roncar
ikotokilistli	ronquido
ikpali	silla
ikpia	contener
ikpialitoamoxtli	índice
ikpialitok	contenido
ikpikaxitl	lámpara
ikpiloli	foco
ikpimachiotl	semáforo
ikpitikayotl	eléctricidad
ikpiuki	eléctricista
iksotl	izote
ikualotl	eclipse
ikxitl	talón
ilakatsoa	devanar
ilakatstik	devanado
ilamaokuili	solitaria
ilamaokuilin	solitaria
ilamapoli	viejota
ilamatl	vieja
ilamatontli	viejilla
ilamatsin	viejita
ilamatsintli	viejecita
ilistli	aguardiente
ilitl	abedul
ilkaua	olvidar
ilnamikili	extrañado
ilochtia	abreviar
ilpia	amarrar
ilpitok	amarrado
iluikalpatlani	ovni
iluikamachioli	telescopio
iluikanemini	astronauta
iluikatlamatilistli	astrología
iluikatlamatini	astrólogo
iluikatlamatli	astro
iluikatlatilistli	astronomía
iluikatlayokan	planetario
iluikayotl	cosmíco
iluitl	día
iluitsintli	fiesta
iluiyotl	festividad
imakasi	tener
imaniatl	época
imaxtli	pendejos
imetstli	pierna
imikistlaneltiliani	martir
immanon	luego
immanyotl	oportunidad
imokaua	sobrar
in	el
ina	atender
inali	atendido
inamik	apropiado
inani	atento
inauak	cercano
india	india
indiatl	indio
indonesia	indonesia
indonesiatl	indonersio
indotl	indio
indotlakatl	indio
indoyotl	hinduismo
inekistli	aroma
inik	artículo
inimeke	estos
inin	esta
inon	esa
ipampa	por
ipan	en
ipanokayotl	general
ipati	costar
ipopotamotl	hipopótamo
irakia	irak
irakiatl	iraquí
irakitekatl	iraquí
irania	irán
iraniatl	iraní
iranitekatl	iraní
irlandatl	irlandés
irlandia	irlanda
irlantekatl	irlandés
isa	despertar
isel	solo
isetlakatl	solitario
isik	temprano
isitia	despertar
isitistli	derpertar
isiukak	rápido
isiukak	veloz
isiukayo	ligero
isiukayotl	diligencia
iskali	surgimiento
islandatl	islandés
islandia	islandia
islantekatl	islandés
istak	blanco
istakaxitl	salero
istakayotl	blancura
istaktli	baba
istaleuak	descolorido
istapali	losa
istapan	ixtapa
istapisiuxitl	cocaína
istatik	blanco
istayotl	salmuera
isteleua	decolorar
isteleuatik	decolorado
istik	frío
istlakatilistli	mentira
istlakayotl	falsedad
istli	obsidiana
istok	despierto
isuamoxtli	cuaderno
isuatl	hoja
itakatl	itacate
itakaxitl	lonchera
itaukayotl	honor
itech	dentro
itechtlajtoa	jurar
itechtlaktok	acreedor
itepotsotilistli	joroba
itestlajtlakoli	síndrome
itetl	barriga
itik	interior
ititi	señalar
ititl	panza
itkin	cuándo
itla	algo
itlakamiktilistli	masacre
itlakayotl	generosidad
itlakoli	dañado
itlakoltilistli	daño
itlalia	italia
itlaliatekatl	italiano
itlaliatl	italiano
itlani	conceder
itlania	ceder
itlanili	concedido
itokalnetsuilistli	sudadera
itokaltsatontli	short
itoktli	costumbre
itomikistli	asfixia
itotia	danzar
itotilistli	danza
itskatki	hielo
itskaxitl	congelador
itskitl	esquite
itskuintli	perro
itskuinyotl	perruno
itsonkuatoli	ceja
itstik	helado
itstli	obsidiana
itsualistli	bisturí
ittoni	visible
iuan	y
iuani	interesante
iuanistli	conjunción
iuatik	desguanzado
iuatilistli	desguance
iuik	de
iuikpa	de
iukayo	natural
iukayotl	naturaleza
ixachi	bastante
ixachitlakaj	americanos
ixchichiliui	sonrrojado
ixchichilka	sonrojar
ixeuayilia	actuar
ixeuayilistli	actuación
ixeuayo	dramático
ixeuayotl	teatro
ixeui	atrever
ixiptlati	sustituir
ixiptlayolistli	cinematografía
ixiptlayotiani	cinematografo
ixiptlayotl	imaginación
ixiptli	imagen
ixkali	cocido
ixkati	dorar
ixkauili	verbo
ixkichi	tamaño
ixkichi	tanta
ixkilistli	esquí
ixkomakali	disputado
ixkomakalistli	concurso
ixkomakayotl	competitividad
ixkomalistli	competencia
ixkonexilistli	semblante
ixkoyan	particula
ixkoyotl	criterio
ixkuamoli	ceja
ixkuapak	despistado
ixkuapali	despistado
ixkuepa	embaucar
ixkuepa	engañar
ixkuikuitlak	lagañoso
ixmachtli	conocido
ixmati	conocer
ixmatili	conocido
ixmauki	tímido
ixnamiki	lidiar
ixnaua	despedir
ixokuaitl	periculosis
ixpan	ante
ixpatsak	tuerto
ixpeui	ahuyentar
ixpopoyok	ciego
ixpopoyoli	cegado
ixpopoyoti	cegar
ixpopoyotl	ceguera
ixpoyaua	encandilar
ixrralia	israel
ixrralnekatl	israelí
ixtaktsin	mangle
ixtaliuik	empolvado
ixtelotli	ojo
ixtetsauakak	tez
ixteuilotl	lentes
ixteutli	pupila
ixtin	caras
ixtisektik	descolorido
ixtiseuatl	efélides
ixtlalia	demostrar
ixtlaltemilistli	cegera
ixtlamachilistli	razón
ixtlamakilistli	razonamiento
ixtlamani	experimentar
ixtlamatia	experimentar
ixtlamatilistli	experiencia
ixtlamatini	experimentado
ixtlan	delante
ixtlapaltik	osado
ixtlapaltilili	entorpecido
ixtlapaltilistli	entorpecimiento
ixtlatilistli	demostración
ixtlauak	valle
ixtlauatl	campo
ixtlauatlakatl	campero
ixtlaui	desvelar
ixtlauik	desvelado
ixtosolixtli	vigilancia
ixtsontli	pestaña
iyeli	pedo
iyelia	pedorrear
iyelmiexini	pedorro
iyemiexini	pedorro
iyomiki	asfixiarse
iyomikki	asfixiado
iyotili	lucido
iyouili	castigo
j	hi
jelenatl	griego
jelenotekatl	griego
jelenoyan	grecia
jelvetekatl	suizo
jelvetia	suiza
jelvetiatl	suizo
jidalgatl	hidalguense
jidalgo	hidalgo
jidaltekatl	hidalguense
jierosalima	jerusalén
jispanilistli	españolismo
jispantekatl	español
jispantlakatl	español
jiyak	hediondo
joladatl	holandés
jolandia	holanda
jolantekatl	holandés
k	ci
ka	estar
kachikatl	cacique
kachuapali	suela
kafekaxitl	cafetera
kafetsin	café
kaj	pues
kakalakastli	sonido
kakalaua	enclavarse
kakalotl	cáscara
kakama	bocas
kakamak	carrilludo
kakamoliuilistli	roncha
kakapaxtli	caspa
kakatsa	saturar
kakauakomitl	castaña
kakauanilistli	fama
kakauatik	hueco
kakauatl	cacao
kakaxtli	madero
kakayaka	desmoronar
kakayakak	desmoronado
kakayaua	burlar
kakayauak	burlado
kakayauatl	burla
kakilistli	consejo
kakiskopinaloni	disco
kakistili	declarado
kakistilia	declarar
kakistini	resonante
kakseseyane	efectivamente
kaktia	calzar
kaktimanilistli	soledad
kaktin	zapatos
kaktiuetsik	calmado
kaktli	zapato
kaktok	callado
kaktonki	descalzo
kakxopetlatl	suela
kalakian	entrada
kalakini	egresado
kalakoayan	puerta
kalakouayan	puerta
kalali	solar
kalan	caserío
kalayotl	cucaracha
kalchaki	sometido
kalchiuani	constructor
kalchiukamatilistli	masonería
kalchiuki	albañil
kalchiutli	construido
kalej	casero
kalejke	caseros
kali	casa
kalitik	estancia
kaliui	devenir
kalixatl	portal
kalixekatl	portal
kalixkuatl	frontera
kalixtlauatl	rancho
kalkayotl	distancia
kalketsani	albañil
kalketski	alarife
kalkimichin	musaraña
kalkua	techar
kalkuatli	techado
kalkutan	calcuta
kalmachtiloyan	colegio
kalmanalistli	construcción
kalmanani	arquitecto
kalmanayo	arquitectónico
kalmanayotl	arquitectura
kalmelaktli	salón
kalmimiloani	chofer
kalmimilolchan	remolque
kalmimiloli	autobús
kalnakastli	esquina
kalokoayan	acceso
kalotl	caparazón
kalpanpili	hidalgo
kalpixki	mayordomo
kalpoli	barrio
kalpoltlajtoli	dialecto
kalsoli	casucha
kaltechtli	rincón
kaltemitl	zaguán
kaltentli	puerta
kaltepiton	caseta
kalteposkalnejnenki	cochera
kaltin	casas
kaltlatlakitl	alhaja
kaltsakualko	prisión
kaltsalantli	callejón
kaltsamaxtli	bermuda
kaltsatl	pantalón
kaltsatontli	pantaloncillo
kamachali	quijada
kamachalkuauyotl	mandíbula
kamaktin	bocas
kamaktli	boca
kamanalatoli	trabalenguas
kamanali	broma
kamanalyotl	mitología
kamanatlajtoa	bromear
kamapantli	mejilla
kamasontli	bigote
kamatetl	cachete
kamatl	boca
kamatsontli	bigote
kamatsonyo	bogotón
kamauak	maduro
kamaxipoli	hocicón
kambodia	camboya
kambodiatl	camboyano
kamerunekatl	camerunés
kameruniatl	camerunés
kameyotl	camello
kamilektik	moreno
kamiltik	café
kamioni	camioneta
kamitl	tunica
kamojpaltik	morado
kamojtik	tierno
kamojtli	papa
kamojtomatl	berenjena
kampaxoa	morder
kan	adonde
kana	a
kanapa	a
kanariotl	canario
kanauak	delgado
kanauakantli	sien
kanauakayotl	delicadeza
kanaukilitl	espinacas
kanautekatl	canadiense
kanautlan	canadá
kanautli	pato
kanik	donde
kanin	dónde
kankenami	sano
kapani	crujido
kapanki	unido
kapolkuauitl	capulín
kapolxokotl	grosella
karakaj	caracas
kasaneli	ciertamente
kasaneli	efectivo
kasanelistli	efectividad
kasaxtania	kazajstán
kasaxtaniatl	kazajo
kasaxtanitekatl	kazajo
katalantekatl	catalán
katalatl	catalán
kataloa	croar
katalonia	cataluña
katona	eliminar
katsaktilistli	suciedad
katsaualistli	suciedad
kaualtia	desechar
kauani	quemado
kauaxilotl	escorzonera
kauayo	caballo
kauayomalakatl	carrusel
kauayomej	caballos
kauayopipitsalistli	relinchido
kauayopipitska	relinchar
kauayoseualistli	equitación
kauayotl	caballo
kauayotlakuali	pastura
kauayotlakuayan	establo
kauilia	terminar
kauitl	tiempo
kautik	adverbio
kaxani	aflojar
kaxauak	suelto
kaxeti	casete
kaxitl	caja
kaxiui	estallar
kaxtilan	castilla
kaxtilastatl	cigüeña
kaxtilchili	pimienta
kaxtilistli	castellanismo
kaxtilkali	castillo
kaxtilkamojtli	zanahoria
kaxtilkuikatl	tuna
kaxtiltekaj	castellanos
kaxtiltekatl	castellano
kaxtiltekayotl	castellanidad
kaxtiltlakatl	castellano
kaxtiltsompanxochitl	clavel
kaxtilxochitl	clavel
kaxtitl	castellano
kaxtli	mortero
kaxtolome	diecisiete
kaxtolpoali	trecientos
kaxtolse	dieciseis
kayamastli	costal
keanatsinkak	sutura
kebek	québec
kechkemitl	quezquimel
kechoatl	quechua
kecholin	flamingo
kechposauilistli	papera
kechtli	cuello
kechxikoli	camiseta
kekeloa	sonsacar
kekeloli	sonsacado
kekexkik	atrevido
kemach	apenas
kemaj	sí
keman	cuándo
kemej	como
kemiloa	envolver
kemitl	manta
ken	como
kenin	cómo
keskin	cuánto
keskintin	cuántos
ketsa	parar
ketsak	parado
ketsalastatl	grulla
ketsalistli	esmeralda
ketsalkayotl	hermosura
ketsalkoskatl	joya
ketsaltik	bello
ketsalxilistli	hermosura
ketsoli	calcañar
ketsontli	crin
kexkemitl	chal
kexkistli	comezón
ki	comerciar
kiaui	llover
kiauitl	lluvia
kiautia	llover
kiauyo	lluvioso
kilimilpan	huerto
kilitl	quelite
kilitlan	hortaliza
kilogramo	kilogramo
kimichtlapeuali	ratonera
kimichtontli	ratoncillo
kinametli	gigante
kinamitl	muralla
kineuki	endemoniado
kinextiani	rebelador
kintanarooense	quntanarroatl
kintepan	después
kintlakatilistli	generación
kinuistanekatl	kinguistaní
kinuistania	kinguistán
kinuistaniatl	kinguistaní
kiotl	retoño
kiribatia	kiribati
kisa	salir
kisalistli	migración
kisempakkayotl	prosperidad
kitemachikayotl	confianza
kitoa	contratar
kitski	tomar
kitskia	agarrarse
kiuak	afuera
kixtiani	cristiano
kiyaui	llover
kiyotl	tallo
koakuechtli	cascabel
koamichin	anguila
koamitl	frambuesa
koatepek	coatepec
koatl	serpiente
koatlakan	ayuntamiento
koatli	gemelo
koauilatl	coahuilense
koauiltekatl	coahuilense
kochi	dormir
kochiantli	recamara
kochilistli	cansancio
kochini	dormido
kochipanamakak	narcotraficante
kochipatilistli	narcotráfico
kochitleua	levantarse
kochitok	dormido
kochitta	soñar
kochiuayan	dormitorio
kochiyan	dormitorio
kochkamachalolistli	bostezo
kochkayotl	cena
kochki	dormido
kochmiki	dormido
kochpan	cama
kochtika	dormitar
kochtli	dormido
kochuetsi	desmayarse
kochuetsilistli	desmayo
koko	sirvienta
kokoa	enfermar
kokojtli	tubo
kokok	picoso
kokolilochtilistli	recaída
kokoliloli	odiado
kokolistli	enfermedad
kokolo	alacranes
kokoloa	impacientar
kokolotl	impaciencia
kokoloyotl	decaimiento
kokoltia	revolver
kokomotsa	paladear
kokonauia	seducir
kokonauiak	seductor
kokonauistli	seducción
kokone	hijos
kokonetlatok	nana
kokosiui	enchilar
kokotl	coco
kokotona	despedazar
kokotonani	despedazado
kokototsautli	hemipléjía
kokoxkali	hospital
kokoxkayotl	agotamiento
kokoxki	paciente
kokoxkui	enfermar
kokoxsiuapixki	enfermera
kokteli	cóctel
koktelxochitl	margarita
koli	abuelo
koliui	acostarse
kolmatl	colimense
kolmekatl	colimense
kolochaui	arrugarse
kolomej	alacranes
kolotik	valiente
kolotl	alacrán
kolotsin	coloche
kolotsinkastli	pegarropa
koltik	torcido
koltin	abuelos
koluakan	culiacán
koluatl	colhua
komak	cóncavo
komali	comal
komantli	comadre
komkonetl	ahijado
komoli	barranco
komoni	apasionar
komoriaj	comores
kompali	compadre
konde	conde
kondoni	condón
konene	bebés
konenetl	bebé
konepatini	pediatra
konetisitl	pediatra
konetontli	niño
konetsintli	bebe
konetsotsomatli	pañal
koni	beber
konko	congo
konkonekatl	congoleño
konkotl	congoleño
konkui	recabar
konkuitli	recabado
kopaktli	paladar
kopali	incienso
kopalkuauitl	pirúl
kopilia	devolver
kopilili	devuelto
kopililistli	devolución
kopiltlajtoa	contestar
kopiltlajtoli	contestación
kopinali	molde
kopinke	zafados
kopinki	zafado
kosamatl	comadreja
kosauak	amarillento
kosaui	amarillarse
kosiuilistli	parálisis
koskatekutli	saturno
kosoli	cuna
kostaktli	sialorrea
kostalauak	colera
kostik	amarillo
kostipapalotontli	palomilla
kostli	amarillo
kostototl	canario
kotaloa	roncar
kotalolistli	gruñido
kotoktik	defectuoso
kotoliloni	odioso
kotonemastli	playera
kotoni	romper
kototsyotl	indecisión
kouili	parásito
kouilin	parásito
kouyotl	cabo
kox	quizá
koxolitli	faisán
koyauak	ancho
koyoakan	coyoacán
koyoktik	agujerado
koyoktli	agujero
koyoli	cascabel
koyolomitl	aguja
koyomikalkali	estuche
koyonili	agujerado
koyonki	agujerado
koyotepek	coyotepec
koyotototl	clarín
kua	comer
kuachalolotl	caracol
kuachikili	cresta
kuachikkili	tocado
kuachikpali	almohada
kuachimali	casco
kuachpantli	estandarte
kuaitl	cabeza
kuakuaminaloni	garrocha
kuakuauaki	ganado
kuakuauemichin	orca
kuakuaueni	vaquero
kuakuaueseseyotl	mantequilla
kuakuauitl	cuerno
kuakuaukali	vaquería
kuakuaumasatl	antílope
kuakuaupixki	ganadero
kuakuautensonpoli	cabrón
kuakuautesontli	cabra
kuakuauton	arbolito
kualani	impaciente
kualania	enojarse
kualanilistli	enojo
kualanki	enojado
kuali	bueno
kualkui	traer
kualnesi	magnífico
kualneskayotl	belleza
kualotl	bondad
kualotli	bondad
kualtokali	recurrido
kualtsin	bello
kuamitl	palanca
kuanakaxtli	guanacaste
kuanakki	débil
kuapixtototl	cardenal
kuatapalkatl	camaleón
kuatekiskitl	caspa
kuatepostli	yelmo
kuatetsonkalistli	mutilación
kuatlatsonkokoli	paraplejia
kuatlatsonkokoltik	parapléjico
kuatsontli	trenza
kuauapastli	artesa
kuauchayauak	verja
kuauchinamitl	veranda
kuauikpali	asiento
kuauitl	árbol
kuaukaktli	zueco
kuaukaxitl	baúl
kuaukomitl	barril
kuaukuetspalin	iguana
kuaumaitl	rama
kuaumatlatl	raqueta
kuaumayo	ramoso
kuaumej	árboles
kuauojtli	boulevard
kuauolotli	porra
kuaupanko	huapango
kuaupantli	estandarte
kuaupetlakaxitl	baúl
kuaupitsaktli	palo
kuausoli	abono
kuausonektli	corcho
kuautemalakatl	carreta
kuautemalatl	guatemalteco
kuautemaltekatl	guatemalteco
kuautepontli	tronco
kuauteskakali	tocador
kuauteuilokali	vitrina
kuautik	alto
kuautilmakali	ropero
kuautiloyan	aserradero
kuautlajtli	bosque
kuautlan	bosque
kuautlapaloni	acuarelas
kuautlasoli	aserrín
kuautlatsakuali	pico
kuautlauankali	alacena
kuautli	águila
kuautoli	madero
kuautolo	cruz
kuautontsin	brócoli
kuautsakuali	palenque
kuauuatsali	palo
kuauxauilistli	chapitel
kuauxiuitl	ramo
kuauxiuyo	enrramado
kuauxoxoutlalistli	aserradero
kuauyektiani	podador
kuauyotl	hazaña
kuaxiloxokotl	tamarindo
kuaxochtli	límite
kuayolo	inteligente
kuayolotl	cerebro
kuechauak	lento
kuechtli	cuello
kuejsouak	presión
kuejsouali	estresado
kuekuepa	pasear
kuekueyoka	hormiguear
kuelkitl	encina
kuelpachoali	doblado
kuemitl	camellón
kuepa	traducir
kuepayoli	revivido
kuepayolia	revivir
kuepayotl	retorno
kuepojtli	calzada
kueponi	brotar
kueponkayotl	primaveral
kueptli	vuelta
kueskomatl	depósito
kuesoli	coraje
kuesoli	corajudo
kuesolistli	coraje
kuetilmatli	lienzo
kuetlapantli	espalda
kuetlaui	desmayar
kuetlaxsauatl	abceso
kuetlaxtli	piel
kuetsokilistli	prurito
kuetspalmichin	pejelagarto
kueyatlalkatl	guanajuatense
kui	tomar
kuikachalania	desentonar
kuikachalaniutli	desentonado
kuikakaxitl	consola
kuikakuakuauitl	corno
kuikamatl	cancionero
kuikani	cantante
kuikapixke	compositores
kuikapixki	compositor
kuikatlamatilistli	música
kuikatlamatini	músico
kuikatlayeualtili	corrido
kuikayotl	música
kuikuili	onix
kuikuiltik	jaspeado
kuilia	quitar
kuiloa	dibujar
kuilonyotl	bisexualidad
kuilotl	oliva
kuitla	cagar
kuitlakali	inodoro
kuitlakochin	cuitlacoche
kuitlasoli	abono
kuitlatl	mierda
kuitlatskopokyotl	negligencia
kuitlaxiloyotl	lomo
kuitlaxkoltomaktli	colon
kuix	acaso
kuuatlatsiuki	maja
kuxoa	estornudar
kuxololistli	estornudo
l	li
lamatl	chirimoya
lamatsapotl	chirimoya
lamitl	cartílago
latinotl	latino
latintekatl	latino
latintlakatl	latino
leoni	leonés
leontekatl	leonés
lesotekatl	lesothiano
lesotia	lesotho
lesototl	lesothiano
libania	libano
libaniatl	libanés
libantekatl	libanés
lichtenstania	liechtenstein
lisipoa	lisboa
litoania	lituania
litoaniatl	lituano
liverpol	liverpool
lotl	cutícula
lusitania	portugal
lusotekatl	portugués
lusotl	portugués
luxenborgiatl	luxemburgués
m	mi
ma	qué
machamo	dizque
machilia	probar
machilistli	conocimiento
machiomiuki	tecla
machionekakilistli	código
machiotia	marcar
machiotl	signo
machiotlajtoa	alfabetizar
machiotlajtololistli	alfabeto
machiotlakuiloni	teclado
machistli	desagradable
machitilistli	estudio
machiyotl	señal
machtiani	estudiante
machtianimej	estudiantes
machtiloyan	universidad
machuastik	digno
madagaskaria	madagascar
madagaskariatl	madagascarense
maili	delicado
maitl	mano
majomakali	mezquita
majomatlakatl	islámico
makakapaktli	castañuelas
makaua	soltar
makixtia	escapar
makoli	brazo
makuayotl	rama
makuilamamachiotl	pentagrama
makuili	cinco
makuilpoali	cien
malakachoa	girar
malakachoni	girador
malakaktli	patín
malakapatoli	ruleta
malakatl	rueda
malakatlayokan	estacionamiento
malaki	disco
malasia	malasia
malasiatekatl	malayo
malasiatl	malayo
malauia	malawi
maldiviaj	maldivas
maleuakuikatl	grave
mali	prisionero
malia	mali
maliatl	malinés
malina	torcer
malinalkatl	malinalca
malinki	torcido
malitekatl	malinés
malkochoa	aprisionar
malkochtli	recubrimiento
malotl	cautiverio
malta	malta
maltatl	maltés
maltekatl	maltés
maluilokayotl	honor
maluiloni	digno
mama	manos
mamajtilok	asustado
mamajtli	asustado
mamasa	venados
mamatlatl	escalera
mamatso	manosear
mamatsouak	manoseado
manchatekatl	manchego
manchatl	manchego
manchatlakatl	manchego
manel	aunque
maneloalistli	natación
maneloani	waterpolista
manenemi	andar
manenemini	mamifero
mani	de
mantsanatl	manzana
mapachoa	asir
mapili	dedo
mapiltepostli	falange
mapilxokoyotl	meñique
martso	marzo
masakonetl	cervato
masasiui	padecer
masasiuilistli	delirio
masasiuki	devanado
masatemitl	garrapata
masatlauelej	manso
masauatl	mazahua
masaxokotl	ciruela
masedonekatl	macedonio
masedonia	macedonia
masedoniatl	macedonio
maseua	danzar
maseualistli	baile
maseualtin	gente
maseualtin	plebe
maseuani	bailarín
maseuayotl	danza
maseukatili	dotado
masik	macizo
maski	aunque
masnekapali	ala
matemekatl	brazalete
matepostli	azuela
matlakome	doce
matlakpoali	doncientos
matlakse	once
matlaktli	diez
matlakualxopiloni	cucharada
matlalsauatl	tifoidea
matlaltsinkatl	matlaltzinca
matlaluili	enrredado
matoma	conquistar
matomali	dominado
matomani	dominante
matopetilistli	boleibol
matsatsini	apaludir
matsikuayotl	incapacidad
matsomalilistli	encuadernación
matsopastli	brazo
matuma	divorciar
maua	contagiar
mauilili	miedoso
mauilistli	miedo
mauisoa	divertir
mauisoli	divertido
mauisolistli	diversión
mauisotl	solemnidad
mauisoyotl	diversión
mauistik	milagroso
mauistli	divino
mauitsoa	engrandecer
mauitsoltelchiua	renunciar
mauitsoltelchiuani	renunciado
mauitsotia	canonizar
mauitstikayotl	autoridad
maukatilistli	miedo
maukatlakatl	cobarde
maukatlayekoani	cobarde
maukatsa	exclamar
maukatsalistli	exclamación
maukayotl	timidez
maurisia	mauricio
mauritanekatl	mauritano
mauritania	mauritania
mauritaniatl	mauritano
mautlakatl	cobarde
mautlakayotl	cobardía
maxaltik	bifurcado
maxeloa	machetear
maxeloni	machetero
maxelotl	machete
maxiltia	suplir
maxiltiani	sustituto
maxiltili	sustituido
maxitia	acercarse
maxtlatl	calzón
maxtli	calzón
mayatekatl	maya
mayatl	maya
mayatlakatl	maya
mayatli	mayate
mayaui	rechazar
mayautli	rechazado
mayeuatl	guante
mayo	mayo
mayumochiua	amén
mekakaktli	abarca
mekamalakayani	conducto
mekania	ahorcar
mekapali	mecapal
mekatepostli	alambre
mekatl	cuerda
mekatlamautli	estambre
mekatlanonotski	teléfono
mekatlatetsautli	quesillo
memachiliani	regente
memej	agaves
menekutli	aguamiel
mesontli	cabeza
metl	maguey
metlapili	metlapil
metlatl	metate
metro	metro
metsesouilistli	menstruación
metspouali	mes
meua	levantarse
meuatiketski	levantado
meuatiketskilistli	levantamiento
mexikaj	mexicanos
mexikanekatl	mexiquense
mexiko	méxico
mexin	mastuerzo
miak	mucho
miaktin	muchos
miaktiyotl	abundancia
michakaxitl	acuario
michimakoyan	pescadería
michin	pez
michmalistli	pesca
michoakanekatl	michoacano
michoakani	pescador
michoakatl	michoacano
michoani	pescador
michoatsali	sardina
michsakuani	charal
michtakauistika	secretamente
michtetl	caviar
michtik	gracioso
michtoton	pececillos
miek	mucho
miexilistli	pedo
miexini	pedorro
mijtoak	chismoso
mikalini	peleador
mikasayolin	catarina
mikasoyoli	catarina
miki	morir
mikilistli	mortandad
mikiloni	tanque
mikini	mortal
mikisnauatilistli	testamento
mikistetl	esqueleto
mikistli	muerte
mikitl	muerto
mikkatekimiloli	mortaja
mikkatepetlakali	sepultura
mikkatsintli	difunto
mikki	difunto
mikoapajtli	veneno
mikomitl	aljaba
mikonexia	micronesia
mikpetlakali	ataud
miktetl	cadáver
miktia	matar
miktilia	suicidarse
miktilo	matado
miktlampan	panteón
miktlantli	infierno
miktlayotl	infernal
miktotopotstli	balacera
mil	mil
milakayo	agrícola
milakayotl	agricultura
milan	milán
mili	sementera
milia	labrar
milkitki	campesino
milpan	parcela
milpixki	agricultor
miltlakatl	labrador
mimakti	recatar
mimaktinemini	recatado
mimatilistli	honestidad
mimatini	prudente
mimatki	derecho
mimiauamej	enjambre
mimiautekatl	apicultor
mimijkatsitsintin	finados
mimikilistli	epilepsia
mimiltik	rollo
mina	lanza
minakachali	lanza
minatini	astuto
mintontli	tatarabuelo
miskikopali	resina
miskitl	mezquite
mitl	flecha
mitotiani	bailarín
mitotiki	danzante
mitotili	baile
mitotilistli	baile
mitotiyotl	danza
mitotl	fiesta
mits-	te
miuki	botón
mixa	misa
mixetl	mixe
mixeui	desprenderse
mixiotl	mixiote
mixiui	parir
mixiuki	parturienta
mixkoatl	nebulosa
mixpoloki	disfrazado
mixtekaj	mixtecos
mixtekatl	mixteco
mixtekomayo	tenebroso
mixtilinaltia	apretarse
mixtlayoltika	misteriosamente
mixtli	nube
mo-	tu
mochi	todo
mochintin	todos
mochipan	siempre
mochiua	acaecer
mojtia	asustar
mokaua	callar
mokaualistli	silencio
mokauani	callado
mokauastli	silencio
moketsa	pararse
mokuepa	convertir
mokuini	acomedido
moleua	amollar
molkaxitl	molcajete
molonia	aflojar
momachtli	alumno
momakixtilia	librar
momayaui	arrojarse
momochkayotl	brillantez
momostla	diario
momostlamoxtli	diario
momostlatika	diariamente
momostlatsinka	diario
momostli	altar
momotlalistli	deporte
momotlalkali	estadio
momotlalo	deportivo
momotsoa	frotar
momoyauali	despoblado
momoyo	mosquitos
monakatl	monaqués
monauak	contigo
monekilistli	necesidad
monekini	necesario
monemilia	pensarse
monkuamoki	singular
montajtli	suegro
mopouak	entendible
mopoualo	entendible
mosanpikia	mozambique
mosanpikiatl	mozambiqueño
mosanpitekatl	mozambiqueño
mosempoua	montar
mosenkauani	dispuesto
mosentlalia	reunirse
mosiuiani	presuroso
moskalia	resucitar
moskalti	crecer
moskaltik	crecido
mostla	mañana
moteka	acostarse
motekak	acostado
moteneua	llamarse
moteopeyotsi	rezar
moteopeyotsiani	rezandero
moteopeyotsilistli	rezo
motetoktli	amparado
motla	disparar
motlailtiani	asqueroso
motlakichilia	rasparse
motlali	sentado
motlalia	asentarse
motlalistli	disparo
motlalkontli	tumba
motlaloa	correr
motlaloani	corredor
motlankuaketsa	arrodillarse
motlapikini	simulado
motlapouia	conversar
motlapouyotl	conversación
motlasolistlapiani	filosofo
motlatia	esconderse
motlauia	posar
motlayololistli	decoración
motoka	llamarse
motolinkayotl	sencillez
motolinki	pobre
motomalakatl	motocicleta
motonalui	tranquilo
mototli	ardillón
motsakki	retirado
motsakua	taparse
motsikoa	pegarse
motsonkui	vengarse
mouan	contigo
moueteuatli	reñido
moxexeloa	separarse
moxochipoloani	goloso
moyekolia	ensayar
moyekolili	ensayado
moyekolistli	ensayo
moyetstika	estar
moyokoyani	dios
moyoleuki	enamorado
moyolkuepki	arrepentido
moyotl	mosco
n	ni
nakakoyonchiuani	barbacoiero
nakakoyonki	barbacoa
nakakualo	carnal
nakalotiloayan	territorio
nakamej	carnes
nakamotki	pulpa
nakanamakani	carnicero
nakanamakoyan	carnicería
nakapoualoni	pañuelo
nakasatsatl	sordo
nakasik	reves
nakaskolotl	agalla
nakastli	oreja
nakastsatsatl	sordo
nakastsonteyotl	arrogancia
nakatamali	nacatamal
nakatetekki	tenedor
nakatlaoyotl	jamón
nakayo	carnoso
nakayomej	carnudos
nakayotl	cuerpo
nali	represa
nalkisa	pasar
nalkixtilistli	transporte
namakatik	vendible
namako	vendible
namibia	namibia
namibiatekatl	namibio
namibiatl	namibio
namiktin	esposos
namiktli	esposo
nana	nana
nanchantli	madriguera
nankilia	rerponder
nantli	madre
nanyotl	maternidad
napaloa	abrazar
napaloani	abrazador
napaloli	abrazado
napalolistli	abrazo
napoli	napoles
nauaj	nahuas
nauak	hacia
nauali	brujo
naualotl	magía
nauatilali	constituido
nauatilalistli	constitución
nauatili	ley
nauatilmatilistli	derecho
nauatlajtolkuepa	cortejar
nauayotl	sonoridad
naui	cuatro
nauilaua	ridiculizar
nauiluitl	jueves
nauojtli	crucero
naupoalomatlaktli	noventa
nautlateuili	cuadro
nauyakoatl	nauyaca
ne	allí
nealtikaxitl	bañera
nealtimaloyan	baño
nechikali	junta
nechikoli	asociado
nechikolistli	conjunto
nechipaualoyan	purgatorio
neijiyotilistli	respiración
neijiyotiloni	respiradero
neikoluayan	antojería
neitonalia	sudar
neitonalistli	sudoración
neixiptlatilistli	encomienda
neixkuitilamakali	copiadora
neixmakilistli	discordia
neixpololistli	disfraz
neixtlapaloli	osado
neixtlapalolistli	osadía
nekaj	ese
nekakayachilili	desmigajado
nekalilistli	batalla
nekalpatlalistli	mudanza
nekaualistli	silencio
nekaukatl	reliquia
nekaukayotl	relicario
nekilistli	voluntad
neknomatlikayotl	humildad
nekokolistli	dolor
nekomonilistli	alteración
nekuaumotlalistli	bolos
nekuiltonolakalkixoani	puertorriqueño
nekuiltonolanauatl	costarricense
nekuiltonolanauatlakatl	costarricense
nekuitilistli	conocimiento
nekumetl	maguey
nekuoktli	pulque
nekupantsin	pastel
nekutlachiuali	conserva
nekutlatepitsauali	turrón
nekutli	miel
neli	verdad
neloani	cuchara
neloayotl	batimiento
nelpiloli	faja
neltik	cierto
neltililoni	probable
neltililostika	probablemente
neltilistemachtiani	predicador
neltilistli	verdad
neltokilistli	credo
neltokokayotl	fe
neltokoni	creyente
neluatl	raíz
neluayo	arraigado
neluayoltia	arraigar
neluayotl	raíz
neluilistli	propósito
nelyolkokolistli	arrepentimiento
nemachtia	enseñar
nemachtiani	maestro
nemachtilkali	aula
nemachtiloyan	escuela
nemachtlapouki	alumno
nemachtokilistli	conocimiento
nemaluali	serio
nemataliskayotl	discreción
nematilistli	cautela
nematini	sensible
nematistli	sentido
nematiuani	sentido
nematkatili	delicado
nematkayotl	urbanidad
nematumalistli	divorcio
nemautilistli	miedo
nemautini	miedoso
nemekatilistli	satiriasis
nemetsuilistli	camisa
nemi	habitar
nemikisnauatilistli	testamento
nemiktilistli	casamiento
nemilia	especular
nemililistli	avance
nemiliskayotl	historia
nemilistlatolotl	mito
nemilistli	vida
nemimiloli	revolcado
nemimiloyan	revolcadero
neminalistli	jabalina
nemini	habitante
neminilistlamatilistli	biología
neminilistlamatini	biologo
nemosiuilistli	aceleración
nemosiuilistli	agonía
nenekilistli	desamor
neneloa	disolver
nenemi	caminar
nenemili	pasaje
nenemilia	pensar
nenemilistli	caminata
nenemini	caminante
nenenki	pasajero
nenepili	lengua
neneuila	comparar
neneukayotl	igualdad
neneuki	semejante
nenextili	rebelado
neneyotl	antigüedad
nenkayotl	vivenda
nenyotl	inutilidad
nepa	allí
nepaltekatl	nepalés
nepantla	centro
nepanyotl	diversidad
nepatl	nepalés
nepatla	desconfiar
nepatlali	desconfiado
nepatlalistli	desconfianza
nepatlautli	desconfiado
nepilotiuechilistli	abatimiento
nesaualispan	cuaresma
nesaualistli	penitencia
nesemixnauatilistli	determinación
nesentlalilistli	concejo
neseseui	ligar
neseseuilistli	ligadura
neseseuilistli	ligue
neseseutli	ligado
neseuilistli	reposo
nesi	aparecer
nesitli	aparecido
neskalikayotl	cordura
neskayotia	significar
neskayotilistli	significado
nesotlalistli	vomito
nestika	quedar
netekipachilili	ocupado
netekoliskoyan	gimnasio
netemachikayotl	esperanza
neteotilistli	adoración
netepitsintili	adoptado
netepitsintilistli	adopción
netetoktilistli	amparo
netlajtolmachitilistli	gramática
netlakanekilistli	fidelidad
netlakanekini	fiel
netlakanekolistli	infidelidad
netlakanekoni	infiel
netlakualistli	dieta
netlakuauketsalistli	constancia
netlakuepilistli	reclamación
netlakuitlauilistli	cuidado
netlakuitlauini	cuidadoso
netlalchitlasalistli	humillación
netlalchitlasoni	humillante
netlalilistli	concepción
netlaloli	legua
netlamachia	angustiar
netlamachiliani	angustiado
netlamachilistli	angustia
netlapikiani	simulador
netlatlalilistli	obligación
netoli	voto
netolinistli	indigencia
netolnotsali	consultado
netoltialistli	profesión
netoniloyan	solana
netontlilistli	amparo
netsomiloni	pañuelo
netsonkuilistli	venganza
neuatia	ordenar
neuejkaualistli	tardanza
neuemini	viviente
neuiuilia	emparejar
nexatl	lejía
nexetinili	derribado
nexikoli	avaro
nexikolistli	envidia
neximalistli	navaja
neximaloyan	barbería
nexkoyomej	lobos
nextamali	nixtamal
nextetl	concreto
nextik	gris
nextilistli	creatividad
nextilo	mostrado
nextiyotl	diseño
neyaotlalistli	enemistad
neyekochiualistli	gimnasia
neyekoni	atleta
neyektokilistli	hipocresía
neyoliximachilistli	conciencia
neyolmelaualoni	confesionario
neyolnonotsali	considerado
neyolnotsa	consultar
neyolnotsalistli	consulta
neyolomaxi	reconocer
neyolomaxili	reconocido
neyolomaxilistli	reconocimiento
neyoltekipacholistli	arrepentimiento
neyoltsonalistli	duda
niau	voy
nichteki	hurtar
nijikoltiani	tirano
nijikoltilistli	tiranía
nik	porque
nikan	aquí
nikanauatl	nicaragüense
nikanauatlakatl	nicaragüense
nikchikauak	confirmado
nikitoa	celebrar
niknoselistli	comunión
niktemaktli	entrega
nikuiko	cuanto
niltse	hola
nin	este
ninauitokak	sentido
nitemana	acaudillar
nitlajtoaloni	micrófono
no-	mi
no	además
nochestli	grana
nochi	todo
nochintin	todos
nochipan	siempre
nochtin	todos
nochtlan	tunar
nochtli	tuna
noijki	también
noiuan	también
noiuki	además
noka	mientras
nonchipa	siempre
nonke	esos
nonoki	derramarse
nonotsalistli	diálogo
nopali	nopal
norvegiatl	noruego
norveginekatl	noruego
noselilia	comulgar
noso	o
notsalo	llamado
nouan	conmigo
nouanyotl	absoluto
nouiampa	dondequiera
noviembri	noviembre
noyuki	también
o	o
ochpantli	avenida
ojpitsaktli	vereda
ojtlachialotl	balcón
ojtlatl	otate
ojtlatokalistli	peregrinación
ojtlatokani	peregrino
ojtli	camino
ojtokak	caminante
ok	aún
okachiuali	futuro
okichkuakuautensontli	chivo
okichmikki	viuda
okichpiltsintli	jovencito
okichtensonpoli	cabrón
okichtensontli	chivo
okichtik	masculino
okichtikautli	varonil
okichtin	hombres
okichtlanki	soltera
okichtli	hombre
okichyotl	proeza
oknamakoyan	vinatería
oknepan	adelante
okoikpayolotl	pavilo
okokalotl	linterna
okosenyolotli	piñón
okoyotl	pinar
okse	otro
okseki	otro
oksekintin	otros
oktli	vino
oktubri	octubre
okuelichpoktli	virgen
okuili	gusano
okuilin	gusano
okyatl	barranca
oli	hule
olin	hule
olinia	mover
olinki	máquina
olinyotl	emoción
olmaitl	baqueta
olmalakatl	llanta
ololtik	redondo
olotl	olote
omantekatl	omaní
ome	dos
omeiluitl	martes
omelia	doblar
omemalakatl	bicicleta
ometliltetl	dieresis
omeyolo	farsante
omeyoloa	dudar
omiketsani	huesero
ominakatini	carroñero
omisikuili	costilla
omitl	hueso
omixochitl	nardo
ompa	allá
ompoali	cuarenta
ompoalomatlaktli	cincuenta
oni	beber
onkan	ahí
onoualkatl	tabasqueño
onoualtekatl	tabasqueño
onouayan	sitio
ontekauani	acompañante
ontetokaitl	sobrenombre
onto	segundo
ontsonmatlakpoali	mil
ontsontli	ochocientos
onyalistli	crecimiento
ooselo	jaguares
opan	según
opochmimatki	zurdo
opochtli	izquierda
oseania	oceanía
oselo	bravo
oselokauayotl	cebra
oselomej	bravos
oselotl	jaguar
oseloyotl	valentía
osomatl	gorila
osomatli	mono
ostiakali	sagrario
ostotakani	minero
ostotl	cueva
ostotla	cavernoso
ostoyotl	mineral
otemok	digerido
otlakalistli	migración
otomitl	otomí
otonlalaxkuauitl	mandarino
otonlalaxtli	mandarina
otsilik	retorcido
otstli	encinta
ouakali	guacal
ouilistli	peligro
ouitepanyalistli	desastre
oyali	desgranado
p	pe
pa	pintar
pachialoa	pasear
pachilia	golpear
pachisijina	chupar
pachisijini	arrugado
pachiui	sumirse
pachiuitl	desnivel
pachiutli	sumido
pachtik	pequeño
paina	correr
painaltli	mercurio
painalton	atleta
paiximatki	herbolario
paiximatkiyotl	herbolario
pakayelistli	salud
pakiliskayotl	felicidad
pakilistli	felicitación
pakini	feliz
pakistanekatl	pakistaní
pakistania	pakistán
pakistaniatl	pakistaní
pakkayematilistli	psicología
pakkayematini	psicólogo
pakki	contento
paktia	gustar
paktinemi	pacifico
paktinemilistli	vigor
paktli	alegría
palalotli	papalote
palanki	fétido
palaxtli	herida
palestinekatl	palestino
palestinia	palestina
palestiniatl	palestino
paleuia	ayudar
pali	pintura
palkoui	hospedar
palmekatl	serpentina
paloa	gustar
palpetlatl	alfombra
paltik	reciente
palxokotl	tamarindo
palyakatl	paliacate
pamitl	banderín
pamitlani	abanderado
pampa	para
panama	panamá
panamakak	farmacéutico
panamatl	panameño
panitlasatl	descubierto
panketsali	bandera
pano	cruzar
pantekatl	penacho
pantilistli	alieneación
pantlani	abanderado
pantlania	abanderar
pantlanilistli	abanderamiento
pantsin	pan
papachtli	deshilado
papakilistika	felizmente
papaloni	relamido
papalotl	mariposa
papalotli	papalote
papantlaka	aletear
papasoloa	enmarañar
papiani	farmacéutico
parauaria	paraguay
parauariatl	paraguayo
parauatekatl	paraguayo
parisi	paris
pasoloa	enmarañar
pasoltik	enmarañado
patilia	herrar
patilistli	sanidad
patioyotl	costo
patiyotl	valor
patiyoua	valer
patla	cambiar
patlachiua	aplastarse
patlachtik	plano
patlali	treque
patlani	volador
patlanilistli	vuelo
patlauak	amplio
patlautli	ensanchado
patli	medicina
patoli	dado
patolsasanili	albur
patoluapali	tablero
patsik	blando
patska	exprimir
patsmiki	aplastar
patsoa	apretar
patstik	magullado
patstli	librillo
paxatl	ceñidor
payanka	desechar
payanki	desecho
payelisyo	químico
payelisyomitili	químico
payelisyotl	química
pechtika	humillarse
pepechtotoniloni	calentador
pepena	levantar
pepenali	recogido
pepenalistli	levantamiento
pepenaloni	recogedor
pepenani	pepenador
pepetla	petates
pepetlakatl	centella
pepeyoka	relumbrar
pepeyokak	relumbrado
petlachiuilistli	ataque
petlachiuki	atacar
petlakali	caja
petlaktik	cromado
petlakui	cromar
petlamiki	petatearse
petlasoli	carpeta
petlasolkoatl	ciempiés
petlatl	petate
petlauak	destapado
petlaualoni	destapador
petsoli	bruñido
petstik	brillante
peualistli	comienzo
peuani	pionero
pia	guardarse
piali	presente
piasketsalistli	tisis
piki	inventar
pikki	macizo
pilatl	infante
piliui	arrugarse
piloa	colgar
piloli	colgaje
piltekatl	distinguido
piltikayotl	nobleza
piltontli	niño
piluan	hijos
piluatia	engendrar
piluatiyotl	alumbramieto
piluilia	acrecentar
pimapan	pimería
pinakatl	pinacate
pinaua	avergonzar
pinauali	avergonzado
pinaualistli	vergüenza
pinauani	vergonzoso
piomej	pollos
pipil	nobles
pipilkali	cubierta
pipiltin	nobles
pipiltoton	niños
pipitska	bramar
pipitski	chillador
pipitskitl	bramido
pipiyolkali	helicóptero
piptontli	tatarabuela
pisili	devastado
pisiloa	devastar
pisiltilistli	devastación
pisiltli	devastado
piskani	recolectar
pitsaktik	delgado
pitsali	pito
pitsauak	delgado
pitsauasetl	lenteja
pitsauautli	cintura
pitsauayotl	delicadeza
pitsokonetl	lechón
pitsopankali	piara
pixka	cosechar
pixkalistli	cosecha
pixkalteki	cosechador
pixki	guardián
pixkitl	cosecha
pixkua	administrar
poa	abrir
pochinki	cardado
pochotl	roble
pochtekatl	comerciante
pochtli	comercio
poktli	humo
pokyo	humeante
pokyotl	aliento
pol-	grueso
poli	grueso
poliuilistli	desaparición
poliuini	desaparecido
poloki	pulque
pololisnetsayotili	señalado
pololokayotl	perdón
polonia	polonia
polontekatl	polaco
polontlakatl	polaco
polotl	polaco
pontsin	ponche
popochkaxitl	incensario
popochtli	aromatizante
popokak	humeante
popokalkisani	chimenea
popokmiki	asfixiarse
popokuaukomitl	pipa
popoliuki	despoblado
popotsoktli	champaña
popoua	criticar
popouayotl	criterio
popoxoa	barbechar
posatilistli	glotonería
posatini	glotón
posaua	inflamar
posauatl	inflamación
posautik	inflamado
posteki	quebradizo
posteki	quebrarse
postektli	quebrado
potlania	derramar
potoni	heder
potonilistli	apeste
potoniyo	apestoso
potositekatl	potosino
potositl	potosino
potsoa	acumular
potsolatl	pozole
potsonali	espuma
potsonilistli	ebullición
pouali	cuenta
poualtlajtoyan	tribunal
poualuastli	calculadora
poualxiutilistli	milenio
pouani	administrador
pouki	contador
poxtik	lila
poxtli	barriga
poyek	salado
puchinchi	terciopelo
q	qui
r	rri
rradioiluikali	radiotelescopio
rradiotl	radio
rrejotl	potro
rrinoserontli	rinoceronte
rrioxanekatl	riojano
rrioxatl	riojano
rroma	roma
rromanekatl	rumano
rromania	rumania
rromaniatl	rumano
rrouandatl	rwandés
rrouandia	rwanda
rrouantekatl	rwandés
rruxia	rusia
s	si
s	zi
saka	acarrear
sakachichimekapan	aridoamérica
sakalistli	acarreo
sakamiyotl	forrajero
sakamoli	mogote
sakani	cargador
sakapik	segador
sakapiloni	segadora
sakatekatl	zacatecano
sakatl	paja
sakatlan	meseta
sakatochin	teporingo
sakauatini	sarnoso
sakauili	zacahuil
sakuali	mediano
saliui	añadirse
saliuyantli	coyuntura
samauki	dilatado
san	solo
sanbia	zambia
sanbiatekatl	zambiano
sanbiatl	zambiano
sanemini	vago
sanitsinka	solamente
saniyo	solamente
sankexkin	moderado
sanoli	abortado
santa	santa
santepan	finalmente
santiago	santiago
santleko	mediano
santo	santo
sanuitstli	foráneo
sanyeno	mismo
sasaltik	brebaje
sasamaua	resignar
sasamauak	pálido
sasamijtoak	chiste
sasanakali	cascabel
sasanaktli	tráquea
sasanili	relato
sasanilistli	adivinanza
sasanilyotl	mitología
satepan	definitivamente
satlatsonko	finalmente
sauali	telaraña
sauatik	sarnoso
sauatl	grano
sayanalistli	contrato
se	un
sealistli	voluntad
seamatl	pliego
seikpatl	hebra
seiluitl	lunes
seki	algún
seki	unos
sekimej	algunas
sekintin	cierto
sekkan	juntos
seknikiski	particular
sekotlasalistli	refrigerio
sektiembri	septiembre
sekuilistli	enfriamiento
sel	solo
selcheyiaj	selchelles
selik	inmaduro
selikayotli	chilacayote
selistli	esencia
seltatl	celta
seltekatl	celta
seltik	tierno
seltikakistli	vocal
seltikayotl	ternura
seltlakatl	celta
semakoltlalpan	península
semana	acaparar
semanaktli	comercio
semanali	acaparado
semanalistli	acaparamiento
semanani	acaparador
semanauak	universo
semanauaktilistli	geografía
semanauatilistli	física
semanauatini	físico
semanauatl	mundo
semani	sencillo
semanilistika	sencillamente
semanilistli	sencillez
semaniluitl	semana
semanka	sencillamente
semankakyeni	eterno
semankayotl	eternidad
semati	conformar
sematilistli	conformidad
semaxkayotl	unidad
semele	agradable
semiak	duradero
semikak	perdurable
semikki	helado
semiluitekitl	tarea
semitki	político
semitkimatilistli	política
semixkoli	cucharada
semocholi	racimo
semolotl	mazorca
sempanauia	superar
sempantli	renglón
sempoalan	zempoala
sempoali	veinte
sempoalomatlaktli	treinta
sempoalxochitl	cempasúchuil
sempoua	multiplicar
sempouali	múltiplo
sempouali	veinte
sempoualistli	multiplicación
semtlaltikpak	tierra
semtlaltikpamatlatl	internet
semtlaltikpatl	terrestre
sen	completo
senegalia	senegal
senegaltekatl	senegalés
senegatl	senegalés
senekomonili	trago
senetlaloli	termino
senetlalolistli	atletismo
seniktlalpan	meridiano
senka	muy
senkamatl	bocado
senkamochiuak	raro
senkaua	disponer
senkiska	enteramente
senkistli	entero
senkolotl	silo
senmixnauatia	escarmentar
senmixnauatilistli	escarmiento
senseknitla	coro
sentekuakuaue	res
sentetika	completamente
sentetl	absoluto
sentetl	completo
sentilistli	unión
sentlachipintli	gotera
sentlakotontli	bloque
sentlakxitl	copla
sentlalpachtontli	fantasma
sentlamantiki	yunta
sentlamantli	articulo
sentlamatin	manada
sentlamayolkatl	rebaño
sentlamia	consumir
sentlamiali	consumido
sentlamialistli	consumo
sentlamotetl	pedrada
sentlani	fondo
sentlasotl	eje
sentlatektli	sorbo
sentlaxitl	paso
sentlinayotl	profundidad
sentson-	innumerable
sentsonuitsauak	constelación
sentsotl	pieza
senualistli	omnipotencia
senuauetilistli	aniversario
senyeliskayotl	familiaridad
senyelistli	familia
senyelo	familiar
senyolotli	piñón
senyoyotl	nuez
sepanka	unido
sepanka	unir
sepantlakuikali	estrofa
sepayali	nieve
sepayaloni	heladera
sepayaui	nevar
sepayauitl	nieve
sepayautli	nevada
sesek	frío
sesekali	refrigerador
sesekmikini	friolento
seseknitla	coro
sesekotlasa	refrigerar
sesekotlasalistli	refrigeración
sesekotlasaloni	refrigerador
sesekpan	iceberg
sesektlan	tundra
seselia	enfriar
seselik	fresco
seselistli	enfriamiento
sesemiluitika	diario
sesemotli	señalado
sesen	cada
sesentlamantli	genero
sesepakatikisa	espantar
sesepakatikisalistli	espanto
sesepaktik	riguroso
sesepatik	espantoso
seseuilo	calmado
seseya	enfriarse
seseyo	seboso
setilia	adicionar
setilistli	unidad
setl	hielo
setlachipinili	líquido
seualotl	sombra
seuetsi	helar
seueuetilistli	edad
seui	apagar
seuilistli	descanso
seuilok	entelerido
seuitsitli	helada
sevilan	sevilla
sexiuitl	ano
seyotl	tuétano
siamikki	cansado
siammikki	cansado
siauali	sopa
siauaya	sopear
siaui	cansar
siauik	cansado
siauistli	cansancio
sijtli	abuela
sili	caracol
silin	caracol
sinbaue	zimbawe
singapuria	singapur
sipetl	labio
siria	siria
siriatekatl	sirio
siriatl	sirio
sirko	circo
sitlali	estrella
sitlalin	estrella
sitlalmatini	astrólogo
sitlalmina	cometa
sitlalminatetl	aerolito
sitlalo	estrellado
sitlalpopokak	galaxia
sitlaltepek	zitlaltepec
sitlalteposakalteyakanki	astronauta
sitlaltlamatilistli	astrología
sitlaltsitsimitl	planeta
siuachichi	perra
siuaikniutli	amiga
siuaikutontli	bisnieta
siuaitskuintli	perra
siuaixoyutli	prima
siuaj	mujeres
siuakaktli	zapatilla
siuakalpolpoui	vecina
siuakauayotl	yegua
siuakokone	hijas
siuakomkonetl	ahijada
siuakonde	condesa
siuakonetl	hija
siuamachtli	sobrina
siuamaxtli	pantaleta
siuamikki	viudo
siuamontli	nuera
siuanauali	bruja
siuanelpiloli	corsé
siuanemachtiani	maestra
siuanenetl	muñeca
siuaokichtik	lesbiana
siuaokichyotl	lesbianismo
siuapilajtokatsintli	reina
siuapili	doncella
siuapiltin	doncellas
siuatekatl	guerrerense
siuatekuanotl	osa
siuatemachtiani	maestra
siuateopixki	monja
siuateotl	diosa
siuatetlanamiuki	criada
siuatik	femenino
siuatisitl	ginecólogo
siuatl	mujer
siuatlachixki	gitana
siuatlaixnamike	concubinas
siuatlajtoani	reina
siuatlakatsintli	dama
siuatlanki	soltero
siuatlatsiuki	maja
siuatontli	niña
siuatotoli	guajolota
siuatoton	niñas
siuauexiutli	suegra
siuauiani	prostituta
siuaxolotl	muñeca
siuayektli	santa
siuayo	mujeriego
siuayotl	feminidad
siyakatl	axila
siyaui	cansar
sokitl	lodo
sokiuia	enlodar
sokiuili	enlodado
sokiyo	enlodado
solatl	hondureño
soloa	envejecer
solotik	envejecido
soltekatl	hondureño
soltik	gastado
solyokan	basurero
soma	ensañar
somali	coraje
somalia	somalia
somaliatl	somalí
somaltekatl	somalí
sonetik	bofo
soneui	astillar
soneuili	astilla
sosolokalistli	zumbido
sotl	inmundicia
sotolin	zotol
soyakapolin	dátil
soyatl	palma
soyatlan	palmar
sudania	sudán
sudaniatl	sudanés
sudantekatl	sudanés
surinamia	surinam
t	ti
tailandatl	tailandés
tailandia	tailandia
tailantekatl	tailandés
taiuantekatl	taiwanés
tajtli	padre
tajtsin	papá
tamajolipan	tamaulipas
tamajolipanekatl	tamaulipeco
tamajolipatl	tamaulipeco
tamali	tamal
tamasoli	sapo
tamasolin	sapo
tanatik	acampanado
tansanekatl	tanzano
tansania	tanzania
tansaniatl	tanzano
taoyotl	taoísmo
tapachkentia	arroparse
tapasoloa	enmarañar
tapauak	pañoso
tapayoltik	esfera
tapechtli	camilla
tayikistania	tayikistán
teaasistli	éxito
teamanalistli	tormento
teaxkatili	don
teayayanoli	desmenuzado
techiali	esperado
techialistli	espera
techiankali	venta
techiauakatlatiloli	gasolina
techiauakayotl	petróleo
techiayotl	esperanza
techichik	alcohol
techikuasentekak	seísmo
techiuikki	alcohólico
techmotlaliani	participante
techtia	apropiarse
teiknelili	privilegiado
teiknelilistli	privilegio
teikneliloni	privilegio
teikniuyotl	sociabilidad
teiknoittalistli	clemencia
teiknoittani	piadoso
teiknotilili	empobrecido
teiknotililistli	empobrecimiento
teiknottalistli	misericordia
teiktliani	bienechor
teilpiloyan	cárcel
teilpiloyatilistli	encarcelamiento
teilpiloyatli	encarcelado
teiluia	reclamar
teiluili	reclamado
teiluilistli	reclamo
teisautli	escandaloso
teisouik	terrible
teitsautilistli	temor
teixkisalistli	elección
teixkuepalistika	engañosamente
teixkuepalistli	falsificación
teixkuepayotl	falsedad
teixnakimikili	ingrediente
teixnamikini	resistente
teixnauatilili	despedido
teixnauatilistli	despedida
teixpak	delantatero
teixpantilia	proponer
teixpatini	oftalmólogo
teixuinotl	cerveza
tej-	tú
tekaktli	huarache
tekaltontli	ermita
tekamauitl	burlón
tekatl	persona
tekaua	sobrepasar
tekelolistli	engaño
tekilolistli	engaño
tekimaktli	encomendado
tekipachoa	preocuparse
tekipani	semanero
tekipanoa	mantener
tekipanoli	mantenido
tekipanolistli	oficio
tekiski	duro
tekitini	trabajador
tekiuak	autoridad
tekiuake	autoridades
tekixkitl	salitre
tekixkiyo	salitroso
tekixtili	desempleado
tekixtilistli	desempleo
tekiyo	sirvienta
tekiyotiani	economista
tekiyotl	negocio
tekmiktiani	homicida
tekmilotl	tabano
teknoloyo	tecnológico
tekochitilili	hospedado
tekochtekalistli	adormecimiento
tekochtektli	adormecido
tekochtlali	arrollado
tekochtli	sepulcro
tekojtin	dueños
tekokolistli	lesión
tekomalpili	tamborcito
tekomatl	percusión
tekomoni	exitado
tekotonalistli	pellizco
tekoyoa	bramar
tekoyolistli	aullido
tekpan	juzgado
tekpana	ordenar
tekpani	dominante
tekpania	dominar
tekpanili	dominado
tekpatl	xílex
tekpili	hidalgo
tekpiltikayotl	cortesía
teksispitsali	caracola
tektelisa	patear
tekuakualistli	postre
tekualakkisani	baboso
tekualnesi	mounstro
tekualtilili	santificado
tekuanokonetl	osezno
tekuatekiloyan	bautisterio
tekuatetsonkatli	mutilado
tekuatl	aguamiel
tekuayotl	fiereza
tekuekuechmiktoani	acosado
tekuia	envolver
tekuikuili	estatua
tekuiloni	homosexual
tekuiltononi	enriquecedor
tekuiluastli	sello
tekukuauilistli	cornada
tekuteokayotl	cofradía
tekuteopixki	cardenal
tekutlajto	diputado
tekutlajtolistli	diputación
tekutli	señor
tekuyotl	dignidad
tel	pero
telchiua	detestar
teleltilistik	embarazada
teleltilistli	embarazo
telketsa	parar
telketsaki	parado
telketsali	parado
telkoyonkatl	esófago
telkuichili	lagrimal
telmatl	redaño
telolotl	aro
telolotli	bodoque
telpochkali	universidad
telpochpan	preparatoria
telpochtin	jovenes
telpochtli	joven
telpokamej	jovenes
telpokatl	joven
telpokayotl	juventud
temachi	confiar
temachia	confiarse
temachtiani	maestro
temachtianimej	mestros
temachtili	doctrina
temachtiloyan	escuela
temachtli	concreto
temachtli	confianza
temachyotl	confianza
temaka	dar
temakak	dador
temakixti	liberador
temakixtiani	redentor
temaktekauani	traidor
temaktia	delatar
temaktili	delatado
temaktilistli	donación
temaktli	entregado
temalakatl	rueda
temalakaxitl	camioneta
temalatl	honda
temalatli	supuración
temalotl	absceso
temamaiutini	terrible
temamalatl	escalera
temamatli	banqueta
temamauti	terrible
temamautik	terrible
temamautini	terrorista
temamautli	temeroso
temanauili	defendido
temasilmatilistli	telecomunicación
tematskali	temascal
tematstisiyotl	terapia
tematumali	divorciado
temauali	contaminado
temauani	contaminante
temauispololi	deshonrado
temauispololistli	deshonra
temauitilistli	enloquecimiento
temauitsotili	honrado
temauitsotl	honra
temauki	contaminado
temautilistli	contagio
temautilistli	susto
temautli	enloquecido
temelauani	atestiguado
temiki	soñar
temiktiani	homicida
temiktiloni	asesino
temiktlan	rastro
temiktli	venenoso
temini	hermano
temitl	cartucho
temo	caer
temoayan	pendiente
temokaxitl	mortero
temolia	descargar
temolistli	descendimiento
temosiuilistli	embarazada
temoskalistli	desarrolllo
temouatl	concurrencia
temouia	descender
tempitsolistli	beso
tena	gemir
tenakaspatini	otólogo
tenakatstilili	ensordecido
tenalistli	gemido
tenamaktli	atributo
tenamiki	besar
tenamiki	encontrado
tenamikilistli	encuentro
tenamikki	topado
tenamitl	muralla
tenankiliani	contestador
tenankilili	respondido
tenankilistli	respuesta
tenantli	talud
tenatkitl	filoso
tenauatekilistli	abrazo
tenauatilili	licenciado
tenauatilistli	defensa
tenaukauilistli	desafío
tenchaya	deshilar
tenchayatli	deshilado
tenchayauak	deshilado
tenchimali	hocico
tenemaktiani	dadivoso
tenesokitl	argamasa
tenisa	desayunar
tenisalistli	desayuno
tenisaloni	almuerzo
tenitstik	afilado
tenix	tenis
tenixlistli	tenis
tenkauali	relieve
tenki	lleno
tenkualaktli	saliva
tenkualaktli	veneno
tenkutli	jefe
tenkuyotl	real
tenochkatl	tenochca
tenonotialistli	disciplina
tenonotsali	relacionado
tenonotsalistli	oración
tenonotsani	relator
tentlauelia	desenfrenar
tentlauelilok	desenfrenado
tentok	amontonado
tentoka	amontonar
tentsakua	confundir
tentsakualistli	confusión
tentsakuani	confuso
tentsonyo	barbado
tentsouki	vuelto
tenyilistli	fama
tenyo	famoso
tenyotekatl	famoso
tenyotl	fama
teoamoxtli	biblia
teochiua	santiguar
teoiluitl	domingo
teokali	templo
teokalkuitlapili	capilla
teokalpixki	sacristán
teokokolistli	elefantitis
teokuaumekatl	rosario
teokuikatl	alabanza
teokuitlamatl	oropel
teokuitlapia	atesorar
teokuitlapiali	tesoro
teokuitlapiayotl	tesorería
teokuitlapitskali	joyería
teokuitlapixki	tesorero
teomachtia	evangelizar
teomachtilistli	evangelio
teopankixtipili	ahijado
teopantli	ermita
teopixkali	monasterio
teopixke	sacerdotes
teopixki	padre
teopixtlajtoani	papa
teosali	ungido
teosentli	teocintle
teotenantli	comadre
teotetajtli	compadre
teotilistli	energía
teotiuakatl	teotihuacano
teotiya	consagrar
teotl	dios
teotlajtoli	oración
teotlak	tarde
teotlakipixki	sacristán
teotlaktli	tarde
teotlakuili	tardío
teotlakyo	tardío
teotlalnoteki	fanático
teotontli	idolo
teoxiuitl	turquesa
teoyojtika	sagrado
teoyokoyani	dios
teoyonantli	madrina
teoyotajtli	padrino
teoyotl	divinidad
tepacholisyotl	gobernación
tepachoua	aplastar
tepak	agradable
tepaleuilistli	favor
tepalkatekatl	alfarero
tepalkonetl	bastardo
tepaltlajtoli	vestigio
tepaltlajtomatilistli	arqueólogía
tepaltlajtomatini	arqueólogo
tepamitl	pared
tepanamikilistli	vecindad
tepanaualistli	victoria
tepanauani	victorioso
tepanaui	vencedor
tepanauili	vencido
tepanchinamitl	corral
tepani	dominar
tepanpitsauak	tabique
tepantilo	asistente
tepantlajtoani	abogado
tepantlakok	elevador
tepanyalo	desastroso
tepapaloani	lamedor
tepapaloani	lamida
tepapalolistli	lamedura
tepatiani	curandero
tepatike	curanderos
tepatiki	curandero
tepatili	sanado
tepatiliani	herrante
tepatilili	herrado
tepatsin	tepache
tepauaniani	vencedor
tepechin	verbena
tepektli	calzada
tepeleuilistli	favor
tepemej	cerros
tepemichin	robalo
tepetilistli	alpinismo
tepetlakatl	montañés
tepetlakayo	serrano
tepetlan	sierra
tepetlatl	tepetate
tepetsalan	valle
tepeuakatl	duranguense
tepeuani	conquistador
tepeuatekatl	duranguense
tepexiuia	desbarrancar
tepexiuik	desbarrancado
tepeyo	alpino
tepitonmachioli	microscopio
tepitonoa	humillarse
tepitsin	chiquito
tepixtlan	ladera
tepokatsintli	espermatozoide
tepolatilili	eyaculado
tepoli	pene
tepolpopolochtli	condón
teposakamitl	submarino
teposamatl	plancha
teposapastli	caldera
teposapiluamina	cañón
teposchikoli	eslabón
teposchiuki	herrero
teposchiupatli	jeringa
teposetili	pesa
teposichikoni	lima
teposkalmimiloli	tren
teposkalnejnenki	coche
teposkaxpechtli	platillos
teposkaxtin	botes
teposkikistli	trompeta
teposkololi	anzuelo
teposkuakuauitl	corneta
teposkuaunektli	sacacorchos
teposkuayolotl	robot
teposkuayoloyotl	robótica
teposkuiloni	sincel
teposmachantli	enrejado
teposmakuauchiuki	espadachín
teposmakuauitl	espada
teposmakuautilistli	esgrima
teposmalakakaltetl	metro
teposmalakasoli	carcacha
teposmalakatl	auto
teposmalakatlalyokan	aparcamiento
teposmalakauayan	cochera
teposmekatl	alambre
teposmitl	proyectil
teposojtli	barandal
teposomitl	punzón
tepospatlanki	avión
tepospatskaloni	batidora
tepospitsauayan	herrería
teposteixiumitl	pistola
teposteixmitl	puñal
teposteki	triturador
tepostemaixiliuani	daga
teposteuitekili	cuchillada
tepostiani	mecánico
tepostik	pasado
tepostlachtli	bala
tepostlakoloni	espátula
tepostlakoni	atril
tepostlakotl	varilla
tepostlakuilo	impresor
tepostlakuiloa	imprimir
tepostlakuilolistli	impresión
tepostlakuimitl	metralla
tepostlaloni	tenazas
tepostlapechtlatsaloni	parrilla
tepostlapilkoyan	campanario
tepostlapitsali	saxofón
tepostlapoani	abrelatas
tepostlasakualoni	candado
tepostlasoli	chatarra
tepostlateuiloni	martillo
tepostlatkitl	herramienta
tepostlatsomaloni	dedal
tepostlatsonaloni	yunque
tepostlauilistli	ballesta
tepostlauitoloa	aballestar
tepostlekuili	estufa
tepostli	metal
tepostotontli	avioneta
tepostototl	avión
tepostsotik	curva
teposuitstli	espuela
teposximani	tijeras
teposxiuki	granada
teposxoktli	cacerola
teposyolotl	motor
tepotsotli	jorobado
tepoxali	tepojal
teseliloyan	posada
teselo	diabólico
teselotl	demonio
tesentlayekoltilistli	plazo
teseuili	aliviado
teseuilistli	alivio
tesi	moler
tesiautli	fatigado
tesiliani	alojador
tesilili	hospedado
tesililoyan	albergue
tesilistli	alojamiento
tesiuitilistli	quejido
teskatl	espejo
tesokistli	flebotomía
tesokitl	yeso
tesouani	lanceta
tetajnantli	padres
tete	piedras
tetech	proximidad
tetechninokaua	comprometer
tetechtlakaualistli	compromiso
tetechtlakautli	comprometido
tetechtoli	prometido
teteixpauiani	acusante
tetekuikalistli	latido
tetenami	muros
teteo	dioses
teteochiuali	santiguado
tetl	piedra
tetlaixtlatilili	desengañado
tetlaixtlatilistli	desengaño
tetlakamatilistli	obediencia
tetlakamatini	obediente
tetlamachiualistli	trazo
tetlamamakani	administrador
tetlamamakili	administrativo
tetlamamakilistli	administración
tetlamolistli	exámen
tetlamotili	examinado
tetlanamiuki	mozo
tetlaneutiani	prestador
tetlaneutili	prestado
tetlaneutilistli	prestamo
tetlanilistli	pregunta
tetlanochili	alcahuete
tetlaokoktli	doloroso
tetlaokolistli	dispersión
tetlapalnauili	preferido
tetlapaloa	vistar
tetlapaloani	visitante
tetlapololistli	salutación
tetlapololtili	escandaloso
tetlapololtilistli	escandalo
tetlapolotili	equivocado
tetlapolotilistli	equivocación
tetlapopoluilistli	perdón
tetlaseseuili	reconciliado
tetlaseseuilistli	reconciliación
tetlasontekilistli	juicio
tetlasontekistli	juicio
tetlasotlalistli	caridad
tetlatsinilistli	palmada
tetlatsinkuinili	salpicado
tetlauelkaki	consentido
tetlauelkakilistli	consentimiento
tetlauitskapitli	desarmado
tetlaxexeluiani	repartidor
tetlaximalistli	adulterio
tetlaxinilistli	respuesta
tetlaxinki	adultero
tetlayekotili	servido
tetlayekotilistli	servicio
tetlayekotini	servidor
tetlayelistli	acompañamiento
tetlechipaualoyan	purgatorio
tetlokoli	acongojado
tetokalistli	continuación
tetokatiutli	seguidor
tetokayo	continuo
tetokayotika	continuamente
tetokayotili	llamado
tetokayotilistli	llamamiento
tetokoyan	cementerio
tetolini	molesto
tetolinilistli	molestía
tetonali	alma
tetoskanamiktilistli	concierto
tetoton	piedrecillas
tetototsalistli	instancia
tetsaka	esterilizar
tetsakali	esterilizado
tetsakatl	esteríl
tetsakatli	esterilizado
tetsatsi	cacaraquear
tetsauistli	castástrofe
tetsauitl	hazaña
tetsaukokolistli	tuberculosis
tetsauyo	aventurero
tetsauyotl	aventura
tetsikolistli	retención
tetsikueuali	cascajo
tetsilmali	retorcido
tetsilmalia	retorcer
tetsilua	torcer
tetsiuitl	triquina
tetskantsontli	urano
tetsontli	tezontle
tetsontsapotl	mamey
tetsonuili	enlazado
tetsonuilia	enlazarse
tetsonuilistli	enlace
tetsonximali	rapado
tetsonyokaxitl	freidora
teuan-	nosotros
teuantin	nosotros
teuantlapoutli	incorparado
teuantsin	usted
teuatl	tú
teuelotika	rigurosamente
teuikpa	hacia
teuiloapastli	botella
teuilotl	vidrio
teutontekatl	alemán
teutontlakatl	alemán
teutotitlan	alemania
teutotl	alemán
teuyo	polvoso
texan	tejas
texankali	auditorio
texiktlasali	difamado
teximani	barbero
texiui	granizar
texiuitl	granizo
texiuitli	granizada
texiutlati	adolorido
texokapolin	arándano
texokapolkuauitl	arándano
texolotl	tejolote
texotlatisilistli	cirugía
texotlatisitl	cirujano
textli	masa
texui	amasar
teyakanalistli	regimiento
teyakanani	regente
teyakanatli	regido
teyakankayotl	realeza
teyaochiualistli	armas
teyaotlani	soldado
teyaouakalistli	avaricia
teyeyekoyotl	tentación
teyoleualistli	movimiento
teyoleutli	movido
teyoliteotilistli	inspiración
teyolmaxilitili	amonestado
teyolmaxilitilistli	amonestación
teyolnonotsalistli	consejo
teyolotili	inspirado
teyolotilistli	inspiración
teyouaski	demolido
teyouki	contrario
ti-	tu
tiamikoyan	plaza
tianamakak	tendero
tiankiski	tendero
tika	eeuu
tiknemitia	acostumbrar
tiknemitili	acostumbrado
tilantok	jalado
tilautli	engrosado
tiliktik	áspero
tilinia	apretar
tilmachiuki	modista
tilmakali	boutique
tilmaloyan	telar
tilmasoani	alfiler
tilmasoli	andrajo
tilmauatl	vestido
timoualkoyan	auditorio
tinkali	tinacal
tisikaxitl	ostión
tisitl	medico
tisiyolkani	veterinario
tisiyotl	medicina
tititl	tititl
titlanekuili	mensajero
titlani	enviar
titlantli	embajador
titsauitl	augurio
tiuej	vamos
tiui	vamos
tixkuilchili	lagrimal
tixtli	diarrea
tiyakautli	valiente
tlaaki	anegado
tlaauitekki	blanqueado
tlachia	ver
tlachialiani	ingenioso
tlachialoyan	ventanal
tlachichia	adobar
tlachichiualoyan	vestuario
tlachichtli	clip
tlachikauali	confirmado
tlachikaualistli	confirmación
tlachikautli	fornido
tlachiki	raspador
tlachikili	raspado
tlachikilistli	raspadura
tlachikochiutli	funesto
tlachipauatonali	sereno
tlachitlasaki	abatible
tlachiuak	acomedido
tlachiuali	conservado
tlachiualistli	conservación
tlachiualkali	taller
tlachiutli	obra
tlachixki	adivino
tlachko	taxco
tlachkottalistli	visión
tlachpantitok	barrido
tlachpantli	barrido
tlachtiloyan	portería
tlachtli	pelota
tlachtopaittalistli	previsión
tlaesotili	ensangrentado
tlaijiyoua	sufrir
tlaijiyoualistli	sufrimiento
tlaijiyouani	sufrido
tlaijiyouilistli	padecimiento
tlailiuischiutli	material
tlailochtili	abreviado
tlailochtilistli	abreviatura
tlaipantilistli	acierto
tlaisiuitili	acosado
tlaispololistli	destrucción
tlaistali	blanqueado
tlaitstililistli	resfrío
tlaixamili	aderezado
tlaixketsali	electo
tlaixmatilistli	conocimiento
tlaixmomotsoli	rasguñado
tlaixmomotsolistli	rasguño
tlaixnamik	novio
tlaixnematilistli	conocimiento
tlaixpantili	presente
tlaixpanyotl	presencia
tlaixpepechilotl	embarrada
tlaixpepecholi	embarrado
tlaixpetlauali	cepillado
tlaixpololi	destrozado
tlaixpololistli	destrozo
tlaixpoloni	destructor
tlajkili	tumba
tlajko	mitad
tlajkotlalpan	tlacotalpan
tlajkotlaltikpan	ecuador
tlajkotonali	mediodía
tlajkotonalpan	mediodía
tlajkotonyotl	parte
tlajkuiloli	escrito
tlajkuilolistli	escritura
tlajpaliuik	villano
tlajtek	adentro
tlajto	hablante
tlajtoa	hablar
tlajtoaki	bocina
tlajtoamatl	códice
tlajtoani	gobernante
tlajtoantepek	monterrey
tlajtokalistli	consejo
tlajtokamekayotl	generosidad
tlajtokateixiptlak	virrey
tlajtokati	reinar
tlajtokayotl	nación
tlajtoke	nobles
tlajtokuepalili	traducido
tlajtokuikani	poeta
tlajtokuikayotl	declamación
tlajtolamoxtin	diccionarios
tlajtolamoxtli	diccionario
tlajtoli	palabra
tlajtolikik	embajador
tlajtolilochtiani	contradictorio
tlajtolilochtilistli	contradicción
tlajtolistli	habla
tlajtolkali	embajada
tlajtolkuepantli	traducido
tlajtolmachiotl	letra
tlajtolmachtiki	gramatical
tlajtolmelaukan	alfabeto
tlajtolnamikilistli	consejo
tlajtololistli	vocabulario
tlajtolsentilistli	glosario
tlajtolyochitl	verso
tlakaj	humanos
tlakakatsali	recalcado
tlakakatsalistli	saturación
tlakakini	hábil
tlakakoayan	auditorio
tlakakoskatl	accesorio
tlakalaki	rendido
tlakalakili	pecho
tlakaltikautli	encarcelado
tlakamachiyo	antropomorfo
tlakamatiyotl	obediencia
tlakamatlakuilotontli	identificación
tlakamatli	obediencia
tlakamej	gente
tlakamekayotl	parentesco
tlakamojeuetl	barbasco
tlakanaua	adelgazar
tlakanautli	adelgazado
tlakanoni	pala
tlakapiltik	criollo
tlakasiui	domar
tlakasiuki	domado
tlakasiutiani	domador
tlakatastali	albino
tlakatekolotl	diablo
tlakatekoloyotl	diabólico
tlakateoyotika	religiosamente
tlakati	nacer
tlakatian	patria
tlakatilisiluitl	navidad
tlakatilistli	engendro
tlakatiltia	fecundar
tlakatl	hombre
tlakatlajtoani	director
tlakatlajtokayo	republicano
tlakatlajtokayotl	republica
tlakatlapouayo	matemático
tlakatototl	avestruz
tlakatsintli	caballero
tlakauak	amo
tlakauali	olvidado
tlakaualotl	sobra
tlakaualtili	impedido
tlakaueyak	gigante
tlakauili	espacioso
tlakaxolotl	bisonte
tlakaxoukayotl	libertad
tlakaxoxoutili	liberado
tlakayomatilistli	antropología
tlakayomatini	antropólogo
tlakechtenkili	degollado
tlakeloli	engañado
tlakemitl	ropa
tlakentia	taparse
tlaketsamimili	columnata
tlaketsomalistli	mordedura
tlakeua	alquilar
tlakeuali	contrato
tlakeualistli	contratación
tlakeuayotl	contrato
tlakilili	encalado
tlakixtili	sacado
tlaknelili	jubilado
tlako	taco
tlakochtli	lanza
tlakokoli	lisiado
tlakokolistli	odio
tlakokoltilistli	revoltura
tlakoni	escalador
tlakoselik	mimbre
tlakotl	vara
tlakotli	esclavo
tlakototsoli	encogido
tlakoualokoyan	banco
tlakoyalistli	depresión
tlakoyokton	agujerito
tlakoyotl	tlacoyo
tlakuakuatli	roído
tlakualanili	enojado
tlakualchikiuitl	panera
tlakuali	alimentación
tlakualkoyan	restaurante
tlakualo	comido
tlakualoyan	comedor
tlakuanotski	anfitrión
tlakuanotstli	invitado
tlakuatl	tlacuache
tlakuatsin	tlacuache
tlakuauastli	peine
tlakuaunapalolistli	apoyo
tlakuauuitekilistli	tala
tlakuepalistli	cambio
tlakuepayolistli	retorno
tlakuikak	cantante
tlakuikalistli	orquesta
tlakuikuitl	esculpido
tlakuikuiyotl	escultura
tlakuilo	pintor
tlakuiloa	escribir
tlakuiloli	historial
tlakuilomachiotl	figura
tlakuiloyotl	pintura
tlakuitiuetsiani	arrebatado
tlakuitiuetsilistli	arrebato
tlakuitlauia	cuidar
tlakuitsoli	regañado
tlakuitsolistli	regaño
tlalalakatl	ganso
tlalankali	sotano
tlalankueskomatl	silo
tlalej	terrateniente
tlalejke	terratenientes
tlali	tierra
tlalkakauatl	cacahuate
tlalkamojtli	camote
tlalkiuak	abundante
tlalkonetl	babosa
tlalkuapa	transladar
tlalkuapalili	transladado
tlalmachiotl	mapa
tlalmatilistli	topografía
tlalnamiki	acordarse
tlalnamikilistli	recuerdo
tlalnemiamoxtli	pasaporte
tlalnemiktia	remembrar
tlalnepanualtilistli	acometido
tlalnetokayotl	chamanismo
tlalnetoki	protestante
tlalnetokini	acatólico
tlalnetokixtianayotl	protestantismo
tlalnetokixtiani	protestante
tlalnetokiyotl	protestantísmo
tlalnokpilualistli	bienaventuranza
tlaloktli	neptuno
tlalomitl	larva
tlaloselotl	ocelote
tlalpan	país
tlalpan	tlapan
tlalpantli	suelo
tlalpitstli	soplado
tlalpoloani	conquistador
tlalpopochtli	contaminación
tlalsematilistli	sedentarismo
tlalsematilo	sedentario
tlalteki	sorber
tlalteli	terraplen
tlaltepeuali	escombrado
tlaltepostli	azadón
tlalteuiloni	pisón
tlaltikpak	mundo
tlaltikpakayo	mundano
tlaltikpakixtianayotl	catolicismo
tlaltikpakixtiani	católico
tlaltikpaktli	tierra
tlaltoktli	sembradío
tlaltsontli	cepa
tlaluake	archipiélago
tlalueltik	lampiño
tlaluitekilistli	tropiezo
tlalxikipili	cantárida
tlamachia	administrar
tlamachilistli	maña
tlamachini	mañoso
tlamachiotilamakaxitl	impresora
tlamachiotili	marcado
tlamachiotilistli	marca
tlamachiua	pesar
tlamachiualistli	trazo
tlamachki	artesano
tlamachtili	alumno
tlamachtilistli	enseñanza
tlamachtilkali	escuela
tlamachtilkalko	escuela
tlamachtilo	aprendido
tlamachtiltin	alumnos
tlamachtli	labor
tlamaitl	manga
tlamakatsintli	sabio
tlamakitilistli	libertad
tlamalakayanili	conducido
tlamalakayanilistli	conducción
tlamalaualili	dirigido
tlamalautli	enderezado
tlamalistli	prensa
tlamaluiloni	fonda
tlamamaliuani	barrena
tlamamaltemoui	descargado
tlamamaltemouia	descargar
tlamamaltemouilistli	descarga
tlamamatl	cargado
tlamamatlatl	grada
tlamamauilistli	espanto
tlamamautini	espantoso
tlamamautli	espantoso
tlamamitsolistli	logro
tlamana	sacrificar
tlamanakali	templo
tlamanaki	sacrificado
tlamanakistli	legislatura
tlamanali	ofrenda
tlamanalistli	sacrificio
tlamanatilistli	costumbre
tlamanayotl	crucifición
tlamanilistli	costumbre
tlamanitilistli	costumbre
tlamantikanilistli	sosiego
tlamantli	cosa
tlamapikili	apretado
tlamaseualnemilistli	romería
tlamaseuani	dichoso
tlamasteokaltoni	monaguillo
tlamatilistemachtiani	catedrático
tlamatilisteokali	catedral
tlamatilistli	ciencia
tlamatilistli	sabiduría
tlamatilkali	casino
tlamatini	científico
tlamatini	sabio
tlamatinimej	sabios
tlamatkatsintli	sabio
tlamatkayelistli	paz
tlamatki	sabio
tlamatkitisitl	partera
tlamatopeualistli	empuje
tlamatsauilistli	admiración
tlamauichiuani	campeón
tlamauisoli	maravilloso
tlamauitsoli	logrado
tlamauitsotili	engrandecido
tlamauitsotilistli	engrandecimiento
tlamautilistli	temor
tlamekanili	ahorcado
tlami	acabar
tlamiktiani	matador
tlamiktili	lisiado
tlamilistli	fin
tlamimiloli	otero
tlamiminaloni	garrocha
tlamini	finalista
tlaminki	flechador
tlamixtentok	nublado
tlamochiualistli	fertilidad
tlamoleui	despegarse
tlamoleutli	desprendimiento
tlamoluili	enjabonado
tlamomoleutli	desprendido
tlamotla	esparcir
tlamotlali	esparcido
tlamoyotl	centella
tlanakasali	embutido
tlanakasanoni	escuadra
tlanakasantli	cuadro
tlanakayotili	engordado
tlanaliuilistli	serenidad
tlanaliutimati	sereno
tlanamakak	tendero
tlanamakiskali	tienda
tlanamiki	acordar
tlanamiktili	encajado
tlanateki	podado
tlanauatili	mensajero
tlanauilistli	adelgazamiento
tlanchiki	silvar
tlanchikini	chiflador
tlanchikitli	silvido
tlanechikoli	reducido
tlanechikolistli	recogimiento
tlanekilistli	voluntad
tlanekuilolistli	contratación
tlaneloli	mezclado
tlaneloni	agitador
tlaneltilili	probado
tlaneltiloni	firma
tlanemakayotl	libertad
tlanemaktilistli	liberación
tlanemani	libre
tlanematkachiualistli	curiosidad
tlanematkachiuani	curioso
tlanemeloli	revuelto
tlanemikan	despejado
tlanemiliani	especulativo
tlanemilili	especulado
tlanemililistli	acuerdo
tlanemilistli	especulación
tlanenekini	deseoso
tlanenelili	comparado
tlanesemixnauali	definido
tlanesemixnaualistli	definición
tlanesi	amanecer
tlaneskayotl	amanecer
tlanexilotl	ventana
tlanextili	relucido
tlanextli	brillo
tlania	pedir
tlaniktilistli	anafrodisia
tlankopinalistli	odontología
tlankopinani	dentista
tlanokpiliuili	conseguido
tlanonotsali	disciplinado
tlanonotsaliani	informador
tlanonotsalistli	información
tlanonotsalo	contado
tlanonotsatli	informado
tlanotonaki	dentista
tlanotonakilistli	odontología
tlanteyotia	apresiar
tlanteyotili	apresiado
tlantisitl	dentista
tlaokoxki	triste
tlaokoyalistli	tristeza
tlaokuili	agusanado
tlaosentlatiloyan	alhóndiga
tlaoyotl	empanada
tlaoyotlaxkali	pastel
tlapachiukayotl	velo
tlapachoa	esconder
tlapacholi	apretado
tlapakkaijyotl	paciencia
tlapalan	tlapala
tlapalchiukayotl	mantel
tlapaleuiani	ayudante
tlapalistli	teñidura
tlapalo	coloreado
tlapaloa	colorear
tlapalolistli	saludo
tlapaloni	pantalla
tlapalsoltik	colorante
tlapaltik	valiente
tlapaltilistika	firmemente
tlapaluia	pintarse
tlapanauilistli	ventaja
tlapanko	desván
tlapantili	acertado
tlapantlasaliani	descubridor
tlapantlasalili	descubierto
tlapantlasalistli	descubrimiento
tlapatili	compuesto
tlapatilistli	remedío
tlapatiotl	trueque
tlapatlaualistli	ensanchamiento
tlapatskitl	exprimida
tlapatsoli	abollado
tlapatsolistli	abolladura
tlapayoltik	esfera
tlapayotl	cuadro
tlapechtli	andamio
tlapechtli	cama
tlapepecholistli	cerramiento
tlapepeualtili	embravecido
tlapetlautli	desnudo
tlapeuali	conquistado
tlapeuiloni	fantasma
tlapeutli	conquistado
tlapiakali	almacén
tlapiali	guardado
tlapiani	guardián
tlapikia	simular
tlapikili	simulado
tlapikilistli	forjadura
tlapiktli	fingido
tlapilchiualistli	defecto
tlapilkoyan	torre
tlapiloli	arete
tlapiluia	aumentar
tlapitsalkuakuauitl	trompeta
tlapitsani	soplón
tlapitsaxikipili	globo
tlapixki	policía
tlapixoli	germinado
tlapixolistli	germinación
tlapiyekuikalistli	trío
tlapoali	número
tlapoalistli	numeración
tlapoalmachiotl	puntaje
tlapoaloni	calculadora
tlapoapatolistli	dominó
tlapolaktili	sumido
tlapoloani	conquistador
tlapopoloani	destructor
tlapopololi	destruido
tlapostektli	doblez
tlapotilistli	apareamiento
tlapouali	número
tlapoualistli	numeración
tlapoualmatilistli	matemáticas
tlapoualmatini	matemático
tlapouilistli	abertura
tlapoukayotl	contaduría
tlapoutli	contado
tlapoutli	vaso
tlapoyauak	crepúsculo
tlasaloloni	betún
tlasaloltia	enseñar
tlasaloua	aprender
tlasatli	derribado
tlasektli	tostado
tlaselili	admitido
tlaselilistli	recibimiento
tlaselmiluia	determinar
tlaselmiluili	determinado
tlaselmiluilistli	determinación
tlasemachtilistli	registro
tlasemanki	comerciante
tlasemijtoli	propuesta
tlasemijtolistli	propósito
tlasemololo	heredero
tlasempaktiani	prospero
tlasempoualistli	orden
tlasenkauali	adornado
tlasenkaualistli	disposición
tlasenkauatli	adorno
tlasenkauyotl	sazón
tlasenkuilia	despojar
tlasenkuilili	despojado
tlasenkuilistli	despojo
tlasentelchiuani	renegado
tlasentlaliamatl	inventario
tlasesekatl	frescura
tlaseselili	resfriado
tlaseselilistli	resfrío
tlaseseuili	enfriado
tlaseseyalistli	frescura
tlaseseyan	invierno
tlaseseyotl	invernal
tlaseualuili	cubierta
tlaseuiani	apagador
tlaseuiloni	extintor
tlasiauitili	cansado
tlasijiuilistli	acoso
tlasiuitili	solicitado
tlasiuitilistli	solicitud
tlaskutli	tendido
tlasojkamatili	agradecido
tlasojkamatilistli	agradecimiento
tlasojtlalistli	amor
tlasojtli	amable
tlasoli	basura
tlasolili	edificio
tlasolistli	reuma
tlasoloni	rastrillo
tlasolyokan	basurero
tlasomani	costurera
tlasosotli	ensartado
tlasotlautli	sobajado
tlasoua	desplegar
tlasouali	desplegado
tlasoualistli	despliegue
tlatakauitsoli	puntada
tlataleualtik	rosa
tlataluiani	procurador
tlatamachili	dimensión
tlatamachilistli	medida
tlatamachioualoni	báscula
tlatayatl	diamante
tlateixpauiani	acusante
tlateixpauili	acuerdo
tlatekalistli	servicio
tlatekpanali	ordenado
tlatekpanalistli	concierto
tlatelchiuali	despreciado
tlatelchiualistli	maldición
tlatemoali	buscado
tlatemoani	buscador
tlatemolili	examinado
tlatemolistli	busqueda
tlatemonilistli	espiración
tlatemouili	descendido
tlatemouilistli	digestión
tlatenaualoni	difamador
tlateneualistli	promesa
tlateochiuali	consagrado
tlateochiualistli	bendición
tlateokixtiani	protestante
tlateotokani	pagano
tlatepitsaualuili	endurecido
tlateposchayauali	enrejado
tlateposkuiloli	imprenta
tlatepostlamachotiloni	reloj
tlatesouili	esponjado
tlatesouilistli	esponja
tlatetepacholi	tupido
tlatetsauak	espeso
tlatetsautli	queso
tlatetsikolistli	estorbo
tlateuatsani	tostador
tlatexoni	majadero
tlatexotl	almidón
tlatia	esconder
tlatilismatilistli	ciencia
tlatilismatini	científico
tlatiuani	señor
tlatkilistli	riqueza
tlatkinamakilistli	publicación
tlatkitl	inmueble
tlatkiuak	rico
tlatla	arder
tlatlachikouili	repartido
tlatlak	quemado
tlatlakatekolo	diablos
tlatlakatl	franco
tlatlakouiloni	atraído
tlatlakuittalistli	ahorro
tlatlakuittani	ahorrador
tlatlaliani	fabricante
tlatlalili	establecido
tlatlalilistli	establecimiento
tlatlamachioki	medidor
tlatlamachtili	enriquecido
tlatlapantli	quebrado
tlatlapiluali	aumentado
tlatlapololistli	clave
tlatlapoloni	llave
tlatlasalistli	tiro
tlatlasi	tocer
tlatlatili	escondido
tlatlatili	secreto
tlatlatilistli	quemadura
tlatlatiloyan	escondrijo
tlatlatl	quemada
tlatlautilistli	ruego
tlatlaxamanilistli	quiebre
tlatlayeni	acompañante
tlatleyotili	engrandecido
tlatleyotilistli	engrandecimiento
tlatloyotl	tlacoyo
tlatokapilatkitl	mayorazgo
tlatokilotl	rodrigón
tlatolilochtia	contradecir
tlatolkuapali	foto
tlatolnamiktli	aconsejado
tlatomatli	desenrollado
tlatotokili	desterreado
tlatotoktli	desterrado
tlatotomali	desenvuelto
tlatotontli	desenvuelto
tlatoualotl	tinieblas
tlatsakuilotl	puerta
tlatsikoli	impedido
tlatsiliniani	campanero
tlatsilinilistli	campana
tlatsilinitepostli	campana
tlatsinkilia	palpar
tlatsintili	introducido
tlatsintilistli	introducción
tlatsistli	chillón
tlatsitskili	sostenido
tlatsiualistli	pereza
tlatsiui	perezoso
tlatsiuini	ocioso
tlatsiuki	holgazán
tlatsonikketsatili	trastornado
tlatsonikketsatli	trastorno
tlatsonki	sastre
tlatsonkilistli	sentencia
tlatsontekilili	jurídico
tlatsontekilistli	jurisdicción
tlatsontekoyan	fuero
tlatsontektli	sentenciado
tlatsontilistli	inflación
tlatsontli	cosido
tlatsotlakilistli	abundancia
tlatsotsonalotl	música
tlatsotsonki	músico
tlatsouasilpili	lazado
tlatsoyoli	asado
tlatsoyoloni	asador
tlatsoyonili	frito
tlatsoyoniloni	sartén
tlatsoyotili	obligado
tlatsoyotilistli	obligación
tlatta	atento
tlauakapanixtlaluak	desierto
tlauanilistli	borrachera
tlauanki	borracho
tlauanoni	taza
tlauantli	curtido
tlauapauali	soldado
tlauapauatilistli	soldadura
tlauapauilotl	rodrigón
tlauapautli	fornido
tlauatik	nervioso
tlauatini	nervioso
tlauatl	nervio
tlauayo	nervioso
tlauejkatlaxtli	diferido
tlauejkauak	detenido
tlauel	muy
tlauele	bravo
tlauelilok	loco
tlauelilokayotl	moldad
tlauelittali	prometido
tlauelittalistli	gusto
tlauelkaki	rechazado
tlauelkaktli	petición
tlauelkixtia	vengarse
tlauelkixtilistli	venganza
tlauelmikilistli	enojo
tlauetsi	otoño
tlauetsiyok	otoñal
tlaui	amanecer
tlauia	iluminar
tlauika	remedar
tlauikali	llevado
tlauikatl	tlahuica
tlauilia	alumbrar
tlauililokani	psiquiatra
tlauililokayotl	esquizofrenia
tlauililolistli	psiquiatría
tlauilistli	iluminación
tlauilo	claro
tlauilokotl	vela
tlauiltekoyan	era
tlauitektli	herida
tlauitl	óxido
tlautik	marrón
tlauyo	oxidado
tlaxamixkalmantli	enladrillado
tlaxantetektli	cubo
tlaxexelostika	distintamente
tlaxikalistli	gotera
tlaxilotl	puntal
tlaxima	engañar
tlaximaltepostli	hacha
tlaxipepanoli	entretejido
tlaxipeutli	desollado
tlaxipinkuatekini	circuncidado
tlaxitinili	desecho
tlaxitinilili	desordenado
tlaxitinilistli	desorden
tlaxitoki	cobrador
tlaxitokilistli	cobranza
tlaxiutlasoli	escardado
tlaxkalatl	tlascalate
tlaxkalchikiuitl	panera
tlaxkalkoltontli	dona
tlaxkatl	junípero
tlaxochiuili	encantado
tlaxochtli	brasíer
tlaxokamalkayotl	gratitud
tlaxoktli	torniquete
tlaxomoli	cuenca
tlaxoxotli	rebanada
tlayakoxtli	criatura
tlayamali	curtido
tlayamanili	entibiado
tlayamanilistli	temple
tlayamanixtimani	abrigado
tlayapixkik	curtidor
tlayekoli	espedido
tlayekotiloni	servidor
tlayektiani	podador
tlayektili	podado
tlayokoxtli	inventado
tlayokoyan	fábrica
tlayolitlakolili	ofendido
tlayolmelaualistli	confeción
tlayolotepitsuili	paciente
tlayolotepitsuilistli	paciencia
tlayolteouili	pronosticado
tlayolteouilistli	pronostico
tlayoua	oscurecer
tlayoualochtia	rodar
tlayoualochtiani	rodante
tlayoualotl	tinieblas
tlayouili	invento
tlayouilistli	castigo
tlayuali	amparado
tleamanali	estufa
tleamatl	cerillo
tlechiualoni	encendedor
tlein	qué
tleko	subir
tlekoasiuilistli	disentería
tlekoayan	cuesta
tlekouia	subirse
tlekouili	subido
tlekueponi	reventar
tlekueponili	reventado
tlekueponilistli	reventón
tlekuesalotia	quemar
tlemauatl	flama
tlemiauatl	llamarada
tlemoyotl	chispa
tlenextli	lumbre
tlensaso	cualquier
tleotlakuili	tardío
tlesakatl	cerillo
tletia	quemar
tletl	fuego
tletlalia	encender
tletlalili	encendido
tleuilotl	lumbrera
tlili	tinta
tlilmachiamoxtli	bibliografía
tlilmachiotl	grafía
tliltetl	punto
to-	nuestro
tochakatl	caracol
tochkonetl	conejito
tochtin	conejos
tochtoton	conejillos
tokaitl	nombre
tokatlalia	firmar
tokatlalistli	firma
tokatlasenkaketl	adjetivo
tokatli	sembradío
tokayotlilneltili	firmado
tokilistli	sembradío
tokuatlak	colmillo
tolchikaualistli	fortaleza
toli	junco
tolichtli	anemia
tolin	junco
toloatsin	toloache
tolpatlaktli	espadaña
toltekali	academia
toltekatl	artista
tomaiskitl	madroño
tomaloni	suelto
tomaokuili	oruga
tomaokuilin	oruga
tomatl	tomate
tomauak	gordo
tomauakayotl	gordura
tomaxak	muslo
tometstli	músculo
tominyi	adinerado
tonakatotl	alimento
tonakayolistli	anatomía
tonalamatl	calendario
tonalmachiotl	reloj
tonalmiki	asolearse
tonalmikki	bronceado
tonalo	zodoacal
tonalpoualamoxtli	calendario
tonalpouali	calendario
tonaluili	asoleado
tonati	sol
tonatiu	sol
tonatiuikalakian	occidente
tonatiukali	cirrostrato
tonatiulistli	asoleamiento
tonatiuyo	solar
tonauik	escalofrío
tonkitl	venus
tonkitli	venus
tons	entonces
tontsontlan	cabecera
topalkatl	tiesto
topalnemilistli	fantasia
topilej	juez
topitsauayan	cintura
topokatl	bebedor
torin	turín
tosan	tuza
tosoani	velador
tosolistli	vigilia
toteputsko	trasero
totlatlakuayan	estomago
totokatl	escaramuza
totokki	desterrar
totolakatl	pluma
totoli	gallina
totolin	gallina
totolkuitlatl	gallinaza
totolpaltini	curioso
totoltepankali	gallinero
totoltin	gallinas
totomak	desatado
totomej	aves
totomilistli	calor
totomiliui	abotonar
totonakatl	totonaco
totonik	caliente
totonikatekatl	veracruzano
totonki	cálido
totonkilistli	calentura
totopoktli	dorado
tototepek	tutotepec
tototsa	adelantar
totpoa	dorar
totstli	tubérculo
traktori	tractor
tsakauili	zacahuil
tsakuali	pirámide
tsakuilia	atajar
tsakuxochitl	lírio
tsanatl	zanate
tsantlauelilok	rapaz
tsapaloli	platano
tsapalolkuauitl	platanero
tsapalotl	platano
tsapokuauitlan	zapotal
tsaponochtli	pitáhaya
tsatsasikpali	sillón
tsatsayania	romper
tsatsi	gritar
tsatsilistli	sonido
tsatsini	pregonado
tsaua	ayunar
tsayanatl	fibra
tsekauastli	cepillo
tsetseloli	sacudido
tsetseloni	colador
tsikauki	detenido
tsikuini	brincar
tsikuinilistli	brinco
tsilichtetl	cristal
tsinakantli	murciélago
tsinchocholi	rabadilla
tsinkestamali	celulitis
tsinkuauastli	peine
tsinkueuali	rajadura
tsintamali	nalga
tsintetl	cimiento
tsintilistli	principio
tsintli	nalga
tsintsinkalistli	terremoto
tsintson	pinzón
tsintsontototl	pinzón
tsitoma	descocer
tsitsikuinoa	sollozar
tsitsilitsa	repicar
tsitsimilo	diabólico
tsitsimimej	demonios
tsitsimitl	demonio
tsitsini	adeherir
tsitsisiunolistli	sollozo
tsitskia	sostener
tsitsokuauitl	laurel
tsoltik	angosto
tsoma	coser
tsompanxochitl	cempasúchil
tsonakauili	sombrero
tsonikpali	almohada
tsonistali	canas
tsonkali	cabellera
tsonkisa	terminar
tsonkisalistli	termino
tsonpili	gripa
tsonpinilistli	gripa
tsontekistli	depilación
tsontekomatl	cabeza
tsontekotl	calavera
tsontli	pelo
tsontsontin	cabellos
tsonyotl	cima
tsopeli	dulce
tsotsokatl	verruga
tsotsomajkiajpaleui	paraguas
tsotsona	golpear
tsotsonak	torpe
tsoyok	sucio
tsoyonia	asar
tsoyonki	frito
tunisia	túnez
tunisiatl	tunecino
turkatl	turco
turkia	turquía
turkitekatl	turco
turmenistania	turkmenistán
turmenistaniatl	turmenistaní
tusan	tuza
tuvalu	tuvalu
u	u
uakak	dueño
uakake	dueños
uakali	guacal
uakaltik	acanalado
uakaxi	vaca
uala	venir
ualalistli	adviento
ualalistli	llegada
ualkistia	salir
ualkistli	porvenir
ualuika	traer
uan	y
uapaltontli	tablilla
uasnenki	transporte
uastli	aparato
uatsaktli	zarzamora
uaualolistli	ladrido
uauana	trazar
uaxyakatl	oaxaqueño
uaxyatekatl	oaxaqueño
ueitotolin	guajolota
ueixolomej	pavos
uejka	lejos
uejkateitstika	distante
uejkatitlantli	cónsul
uejkatlajtolkali	consulado
uekaixipkaxitl	televisión
uekapak	soberano
uekayotl	antigüedad
uel	muy
uelamati	acudir
uelamatini	recurrido
ueleyatl	sandía
uelik	rico
uelikamatilistli	sentido
uelikayo	suavisante
uelikayotl	suavidad
ueliti	poder
uelitini	capaz
uelitiyotl	poder
uelitta	gustar
uelittaloni	aparecido
uelkaki	aceptar
uelkamatili	apreciado
uelkamatilistli	aprecio
uelnesi	apuesto
uelomik	finado
uelomiki	finado
ueltlajtoli	lenguaje
ueltlakuilo	reportero
uetsi	caer
uetska	reir
uetskalistli	broma
uetskayotl	risa
uetski	caído
uetskistomak	risueño
ueue	viejo
ueuetili	envejecido
ueuetini	anciano
ueuetl	tambor
ueueyotl	vejez
uexiutli	suegro
uexkatlajto	blasfemo
uexkatlajtoa	blasfemar
uexkatlajtoli	blasfemia
uexotsinkatl	huejotzinca
uey	grande
ueyamoxtli	enciclopedia
ueyauilnemilistli	orgía
ueyejekatl	torbellino
ueyikpali	banca
ueyiya	crecer
ueykali	rascacielo
ueykalmimiloli	trailer
ueykuetspalin	dinosaurio
ueymekaueuetl	contrabajo
ueyojtli	autopista
ueysitlali	lucero
ueysiuatlajtoani	emperatriz
ueytemachtiani	doctor
ueytepachoteopixki	patriarca
ueyteposkoyoli	campana
ueytepostli	acero
ueytlajtoani	rey
ueytlajtokayotl	imperio
ueytlalpan	continente
ueytlamachtilkalko	universidad
ueytlamauisoltika	maravillosamente
ueytlapitsalkuakuauitl	tuba
ueytlasololi	rascacielo
ugandatl	ugandés
ugandia	uganda
ugantekatl	ugandés
uichotl	huichol
uik	hacia
uikalo	llevado
uikayotl	pena
uikia	venir
uikilia	deber
uiktli	azadón
uilistlajtoli	proceso
uilokonetl	palomino
uilontli	homosexual
uilonyotl	homosexualidad
uilotiani	homoxesual
uilouayan	cielo
uipana	aglomerar
uipani	aglomerado
uisi	bici
uisi	cocerse
uisiketla	bicicleta
uitetl	vientre
uitoloua	flechar
uitsachin	huizache
uitsilin	colibrí
uitsiloxitl	balsamo
uitsitsilin	colibrí
uitskilitl	cardo
uitsmetl	aloe
uitsnauatl	biznaga
uitsoktli	barra
uitstik	afilado
uixkayotl	convulsión
usbekistanekatl	uzbeko
usbekistania	uzbekistán
uxitl	resina
v	u
vakaxi	vaca
valensia	valencia
valensianekatl	valenciano
valensiatl	valenciano
vanuato	vanuatu
vaxkatekatl	vasco
vaxkatl	vasco
venesolan	venezuela
venesolatl	venezolano
venesoltekatl	venezolano
videokaxeti	videocasete
vietnamia	vietnam
vietnamiatl	vietnamita
violi	violín
violin	violín
violnemini	violinista
x	xi
xakali	cabaña
xakaloa	fechar
xakualoli	despercudido
xakualtia	sobajar
xalan	duna
xalapan	jalapa
xalixko	jalisco
xalixkotl	jalisciense
xalixtekatl	jalisciense
xalo	arenoso
xaltomatl	jaltomate
xamaika	jamaica
xamaikatl	jamaiquino
xamaitekatl	jamaiquino
xamania	hender
xamanilteka	entablar
xamixkaltexkaxitl	horno
xamixkoyan	ladrillera
xamixtli	ladrillo
xapotekatl	japonés
xapotl	japonés
xaxamakalistli	estrundo
xaxamakani	rompeolas
xaxamatsa	crujir
xayakatl	cara
xayaktli	careta
xeliuilistli	división
xelotok	apartado
xetinia	derrocar
xexelo	distribuido
xexeloa	dividir
xikalankatl	campechano
xikalantli	cenote
xikali	jicara
xikamatl	jícama
xikipiliuistli	chichón
xikipiltomin	monedero
xikitsoa	difamar
xikoatl	cometa
xikokuitlali	vela
xikokuitlaltia	encerar
xikokuitlaochiuki	candelero
xikokuitlaokotl	vela
xikokuitlatl	cera
xiktlasa	calumniar
xikuetsi	deshorar
xilantli	barriga
xilotepek	jilotepec
ximali	astilla
ximani	trasquilador
ximopanolti	bienvenido
xina	china
xinachtli	semilla
xinachyo	semental
xinachyotl	esperma
xinaloani	semillero
xinaloatl	sinaloense
xinia	deshordenar
xiotl	jiote
xipetsa	desnudar
xipetsok	desnudo
xipeua	despellejar
xipeualistli	desollamiento
xipinkuayotl	circuncisión
xirafatl	jirafa
xitekuikalistli	ruido
xitenia	derrocar
xitik	descompuesto
xitlatsoa	alisar
xitomatl	jitomate
xittontlali	estallido
xittontlalistli	explosión
xittontlani	explotar
xittontlanili	estallido
xittontlanilistli	explosión
xittontlaxochitl	cohete
xiuatl	té
xiuitl	condimento
xiukaloyan	abacería
xiukomitl	tinaja
xiumolpiloyan	era
xiupouali	anuario
xiutepalkatl	cerámica
xiutin	años
xiuuitsoli	mitra
xiximi	derramar
xixinia	desbaratar
xixiui	desarmar
xixotl	empeine
xochayotl	galápago
xochiastatl	flamingo
xochiauiyalistli	aroma
xochikamojtli	zanahoria
xochikuikani	poeta
xochilia	abrotoñar
xochimanki	floricultor
xochimej	flores
xochimichin	salmón
xochimilkatl	xochimilca
xochimojpaltik	lavanda
xochimoyeuak	floreado
xochiokotsotl	sahumerio
xochipaltik	rosa
xochipoktli	aromatizante
xochisiuistli	hemorroides
xochitl	flor
xochitlakualistli	golosina
xochitlakuani	goloso
xochitlalpan	paraíso
xochiyo	enjundioso
xochiyotl	enjundia
xokiyak	fétido
xokok	agrio
xokomandarina	mandarina
xokomekamili	viña
xokomekatetsoli	pasa
xokomekatl	uva
xokonochtli	xoconoxtle
xokoya	acedarse
xokoyok	úiltimo
xokoyoli	trébol
xokoyotl	benjamín
xoktapayolistli	fútbol
xolopitli	tonto
xoloxayakatl	gesto
xomachiotl	pie
xomachiualoni	pie
xomili	jumíl
xomilin	jumíl
xomoli	rincón
xonakatlan	xonacatlán
xonexka	prevenir
xonotatl	sonorense
xonotekatl	sonorense
xonpepetl	cuchara
xopalmachiotl	patada
xopan	primavera
xopanistli	primavera
xopanitstempakayotl	primaveral
xopanitstempan	primavera
xopeleuak	verdoso
xordanekatl	jordano
xordania	jordania
xordaniatl	jordano
xotexokotl	níspero
xotl	pie
xotli	crudo
xouakki	flaco
xoxali	hernia
xoxochilistli	verdura
xoxochitlan	vergel
xoxoktik	verde
xoxoktli	verde
xoxolistli	golpe
xoxoni	shoshón
xoxotl	idiota
xoxotok	golpeado
xuan	juan
xulio	julio
xunio	junio
xupan	verano
xupantlakayotl	veraniego
xupantlan	verano
y	yi
yakana	adiestrar
yakapotonili	constipado
yakapotonilistli	constipación
yakatli	punta
yakauki	acabar
yamania	ablandar
yamanik	cálido
yamanili	ablandado
yamankak	amable
yamankakuikatl	murmullo
yamanki	suave
yamastik	suave
yankuik	nuevo
yankuiliskayotl	novedad
yankuilistli	novedad
yankuitl	mestizo
yankuitlakatl	mestizo
yanonasi	acercar
yaokali	fortaleza
yaokiski	soldado
yaoktlayekoani	militar
yaokuachpanitki	alfil
yaotl	enemigo
yaoyotl	guerra
yapali	colorante
yapaltik	colorante
yauali	circulo
yaualiukayotl	redondez
yaualoa	redondear
yaualtik	circular
yaukatlayotl	vanidad
yaukayotl	propiedad
yei	tres
yeiluitl	miércoles
yej-	el
yek	derecha
yekaukayotl	perfección
yekilistli	costumbre
yekkaki	entender
yeknakayotl	amabilidad
yeknemilistika	religiosamente
yeknemilistli	religión
yekolti	convidar
yekteneua	santificat
yektia	podar
yektik	perfecto
yektlalia	componer
yektlalili	compuesto
yektli	santo
yelia	comportarse
yelimiki	arado
yelistli	comportamiento
yelisyotl	naturaleza
yelsisiyotkatl	pechuga
yeltik	sustantivo
yeouilpa	anteayer
yesej	pero
yesini	primo
yesneluatl	vena
yestli	sangre
yetik	pesado
yeto	tercero
yeui	caber
yeuiptla	anteayer
yeyamatilistli	meteorología
yeyamatini	meteorólogo
yeyantli	lugar
yeyektin	buenos
yeyolmaxilili	satisfecho
yoali	noche
yokoxkayotl	paz
yokuxkayo	reposado
yolchikaualistli	esfuezo
yolia	vivir
yolik	despacio
yoliliso	espiritual
yolilistlajtoli	dialogo
yolilistli	ánima
yolismatilistli	filosofía
yolismatini	prudente
yolismatkayotl	prudencia
yolismatki	astuto
yolistli	vida
yolitl	acémila
yolitlamanemi	jubilado
yolixtli	conciencia
yolkaikniutli	mascota
yolkamej	animales
yolkapoli	animalejo
yolkatl	animal
yolkatontli	animalillo
yolkatsin	insecto
yolkatsintli	animalito
yolmiki	desmayar
yolmikilili	desvanecido
yolmikilistli	desvanecimiento
yolnankilia	aprobar
yolnankilili	aprobado
yolnanqulistli	aprobación
yolokakiloni	estetoscopio
yolokimali	descuidado
yolokimatia	descuidar
yolokimatilistli	descuido
yolokokolkuik	iracundo
yolokuekuepkayotl	inconstancia
yolomachilistli	prudencia
yolomatki	prudente
yolopoliukayotl	locura
yolosemanauatini	ecologista
yolosemanauayotl	ecología
yolotlapaltik	generoso
yolotli	corazón
yolotsin	corazoncito
yolotsintli	corazoncito
yoloxokuauitl	melocotonero
yoloyotl	corazonada
yolpachiui	contento
yolpaki	alegrar
yolseukayotl	mansedumbre
yoltik	despacio
youalapia	rondar
youali	noche
youikuik	anal
youinemilistli	modestia
youinemini	modesto
yoyoli	sabandija
yoyolo	corazones
yoyomitl	prenda
yudiokali	sinagoga
yudionesentlalistli	judería
yudioteokali	sinagoga
yudiotl	judío
yudiotlakatl	judío
yudioyotl	judaísmo
yukatan	yucatán
yukateyolistli	intento
yukateyolisyotl	intención
yukateyoloni	intencional
yuki	tal
yukin	así
yutan	utah
yutatl	yutano
yutli	yute
¡chia!	¡espera!
¡kauik!	¡calma!
¡nanaj!	¡asomate!
¡pakiliskayoli!	¡felicidades!
¡uejkapa!	¡alto!
¿kajtli?	¿cúal?